그걸 그대로 믿고 확인 안 상주시 대단하다	TRUE
또 경상도 신천지 에이 어 뭐 대체	FALSE
지긋지긋 하다 개독 들  바뀌 벌레 못 한 것 들 쯔쯔쯔	FALSE
종교 이쯤 되면 사회 악 중 최대 해악  특히 개독교 몸 정신 완전히 망친다 마약 더 해롭다 고 생각 한다	FALSE
확 진자 발생 시 모든 책임 져야겠지요  절대로 국가 무료 치료 해주는 일 없다 그리고 형사 처벌 감수 해라	FALSE
이건 기독교 가 아니다  광신 교 집단	FALSE
프리메이슨 이 루미 나이트 베리칩 등 성경 나오지도 않는 것 주장 주로 건전한 목회자 들 까면서 몰래 포교 하는 집단 또다른 이단	FALSE
국가 시민 안전하게 지킬 의무 있죠 무료 치료 당연히 국가 해야 할 일이 형사 처벌 고소 하셨어요 본인 못 할거면 말 하지 마세요	FALSE
ㄱㅅ 광신 교 이런 욕 크리스천 칭찬 아시	FALSE
이 루미 나이트 ㅋㅋ 일루미나티 겠죠 당연히 성경 나올 리가 없지 성경 그런 걸 적는 데 아니니까 몰래 포교 건전한 목회자 그런건 없어요 왜냐면 다 같이 죄인 이	FALSE
본인 나라 뜨시면 되겠네요	FALSE
그럼 이민 가세	FALSE
ㅋㅋㅋ 그런 기도 왜합 할 필요 없는데	FALSE
그 놈 종교 행사	FALSE
종교 행사 많이 나오는 것 아닌가요	FALSE
내용 잘 알 댓글 달았으면 좋겠습니다 교회 목사 님 설교 강단 충분히 거리 떨어져 있는 상태 교인 들 마스크 모두 착용 상태 이기 때문 다른 어느 곳 안전합니다 교인 가까이 있을 때 마스크 필히 착용 있습니다 교회 상황 잘 모르면서 단순한 기사 보고 교회 개신교 폄하하는 내용 삼 가해 주시 좋겠습니다 물론 일부 교회 잘못 인정 합니다 하지만 대부분 개신교회 방역 사항 가장 철저히 준수 있습니다	TRUE
술집 클럽 가봐라 그리고 기사 써  지긋지긋하다 국민 눈 귀 막는 기사 내지	FALSE
교회 목사 이 말 들어도 이제 징글징글 하다	FALSE
마치 교회 코로나 전파 주 범인 것 처럼 과장 보도 하고  유흥업소 먹자 골목 가봐라 그 쪽 감염 되서 교인 전염 될 일 없겠냐	FALSE
질 본 브리핑 시작 해서 티비 수많은 사람 들 마스크 없이 인터뷰 회의 아이돌 집단 춤추고 노래 할 때 마스크 안 쓰고 접촉 가능성 많은 운동 선수 들 하나 마스크 안 쓰고 드라마 영화 다 마스크 안 쓰 더구만 특히 질 본 브리핑 할 때 제발 마스크 좀 써라 가장 본이 되어야 할 질 본이 그러고 있으니 누가 마스크 쓰려고 하겠냐 옆 수화 하는 사람 들 마스크 좀 쓰고 마스크 안 쓰고 목사 설교 더 오래 브리핑 하는 사람 바로 옆 마스크 안 쓰고 생명수 당 받나 모르겠구먼	FALSE
이 것 기사  라이  식사 때 마스크 쓰고 식사 하냐	TRUE
목사 주님 말씀 전파 하는게 아니라 코로나 전파 있네 왜 교인 들 그걸 보면서 참지 본인 가족 죽 수도 있는데 왜 방관 하지	FALSE
티비 보면 다 들 마스크 안 방송 하던데  심지어 노래 열심히 들 하고 방송국 코로나 없나 교회 엄격하게 하는 이유 알 싶군요  좀 공정하게 보도 합시다	TRUE
코로나 지겹다  이 제 좀 끝내자  이런게 목사  협조 좀 살어라	FALSE
xxx 들아 좀 그만 좀 해 사람 들 다 죽일 셈  예배 할려면 방역 수칙 지키라는데 하라 쫌해  예수 사람 들 코로나 전파 하 더냐 왜 아예 집집 방문 해서 전파 하지 진짜 지긋지긋 하다 이제	FALSE
목사 그렇지 뭐  이제 놀랍지도 않다	FALSE
쓰레기 목사 교회 놀이 하네	FALSE
관공서 가봐라  가보고 기사 쓰라	TRUE
종교시설 하면되 나  주 교회 해야지	FALSE
범죄자 목회자 되기 쉬운데 중랑구 시설 한해 명 씩 배출 ㅋㅋ	FALSE
역시 교회 일빠	FALSE
교회 아니라 암 덩어리 집단	FALSE
ㅡㅡ 정부 국민 들 말 들어라 ㅡㅡ 단계여도 교회 페쇠해 ㅡㅡ 계속 퍼지 자 ㅡㅡ 휴 ㅡㅡ	FALSE
거리 두기 단계 쫌 성급한것 아닌가요 여기저기 모임 다 고 난리 던데 괜찮을지 불안하네요 이 젠 코로나 일상생활 편해진건 아닌지 걱정 됩니다 목숨 위태 롭다 는걸 잊지 마시고 방역 지침 잘 따라서 코로나 사라졌음 합니다 마스크 제대로 씁시다	FALSE
양심 없어도 너무 없네 교회 어지간히 갖고 놀아라 그래도 교인 들 착한 편이 걍 참는다	TRUE
신자 들 모두 마스크 쓰니 신부 본인 안 써도 된다고 하는 성당 있다	FALSE
기자 쓰레기 쓴다고 다 기사 되는줄 아 나본 데 놀지말고 기사 다운 기사 써라	TRUE
교회 또 까불기 시작 하네 책음저 야할  목사 이런 행동 하다니  또한 번 뒤집어 지겟네 제발 교인 들  마스크 좀 쓰자  코로나 균 하느님 그리 중요하 나제 뱔	FALSE
식당 들 흡연 장 유흥업소 관광지 공원  솔직히 다 들 느끼 자나요  말 안해  백종원 호텔 코로나 방이 없다고 띄워주는 기사도 나오던데  솔직히 전염병 창궐 한지 몇개 월 지났는데 명대 확 진자 말 되나요	FALSE
징글징글 해 아직도 교회	FALSE
마스크 안 쓴 목사 설교 듣는 신자 들  이해 안 오네 내 같으면 지 적하 거나  뛰 쳐나와 다시는 안 가겠다	FALSE
진짜 사람 들 무식하다 그러면 카페 식당 술집 노래방 다 안 돼 교회 더 위험한 곳 가게 들 뎈 ㅋㅋㅋㅋㅋㅋ 그리고 기독교 안 파가 나뉘는데 전광훈 진짜 순수하게 하나님 믿는 목사 들 인정 하지 않는 목사 그냥 직업 목사 뼈 속 정치 해서 자기 이익 얻으려는 사람 기독교 싸잡아 욕 하지마 셈 그리고 밤 홍대 강남 부산 등 시내 나 가봐라 술 마시고 마스크 안 쓴 사람 절반 넘는다 정치 판 기독교 좀 빼 ㅠㅠ 제대로 된 목사 들 지금 전광훈 때문 정말 힘들어 한다 어른 들 말 좀 더 둥글게 사용 합시다	TRUE
노래방 띄어 앉으면 된다 하고 공연 하고 있고 뉴스 마스크 없이 하고 가수 들 트로트 들 무수 히 노래 랄 하면서 왜 설교 자만 마스크 흐 하라 거 공정하냐 도대체	TRUE
나라 어디 하소연 할 곳 없으니 함부로 할수있다고 여기는 교회 잡으며 교회 봉	FALSE
웃기는 처사 뉴스 언론 왜 침 튀기며 아스 크안 쓰냐 교수 님 쓰냐	FALSE
기사 수준 이하 생각 됨 어거지 어거지  방송 드라마 뿐 아니라 TV 나오는 모든 사람 들 마스크 안 쓰고 나오면  명단 만들어서 꼭 기사 올려요 ㅋㅋㅋ	TRUE
진짜 그러지 맙시 제발 교회 모범 좀 보입시다	FALSE
그냥 공개 합시다	FALSE
전세계 차 대유행 데 우리나라 종식 된줄 아는 사람 들 때문 너무 위험합니다	FALSE
ㅋㅋㅋㅋ 진심 교회 욕 하는건 아니지만 교회 사람 들 노답   마스크 좀 제대로 쓰고 다니세요	FALSE
이건 코로나 사태  진짜 기독교 아니다	FALSE
클럽 한강 술집 운동 하는 곳 촬영 다 안 써요 교회 욕 해요	FALSE
목사 님 들  그리스도교 품위 있는 종교 입니다  그런데 목사 님 들이 그리스도교 망신 시키고 있습니다 제발 품위 좀 지키세요	FALSE
방역 수 칙 거역 건 사회 악당 😡😠💢	FALSE
미쳐 버리겠네 😡😠💢	FALSE
확 진자 조사해 미경 로 확 진자 경 각심 왜 없냐	FALSE
여 에스터 쌍판 광고 치워라 토 할것 같다 저걸 쌍 판이	FALSE
하지말라는 것 골라 서한 다 진짜 그러면서도 큰소리 초딩 애 들 못 하네	FALSE
마귀 같은 목사 들	FALSE
야 이 사람 들 좋은 말로 할 때 마스크 쓰고 거리 두기 확실하게 합시다 쫌	FALSE
그러니까 단계 격상 쟈 ㅡㅡ	FALSE
설교 할 때 마스크 쓰는게 뭐 그렇게 어렵다고 안 쓰나 이해 할 수 없다	FALSE
예수 쟁이 들 외 그러냐 하 님 이그리 갈치디	FALSE
목사 사회 악  없어져 야할 직업 그 조직 들	FALSE
개독교 하는 짓거리 보면	FALSE
악의 적 편파 가사 네 교회 마스크 안 끼나요  까페 편의점 등 요 방송 프로그램 연예 전부 마스크 안 끼지 않나요 교회 충분히 방역 수 칙 잘 지키고 있습니다 언론 공 정성 잃지 않았으면 좋겠네요	TRUE
방송국 나와서 발표 하시는 분 들 모두 마스크 쓰시 인정 할께요  설교 자 회중 간 거리 미터 정도 되는데 태클 걸지 마세요	TRUE
설교 마스크 쓰고 하기 어렵습니다 교회 방역 수칙 잘 지키고 있는데 일부 전광훈 사이비 지지 하 집단 잘 담속 하십시요	TRUE
우리나라 개신교 천주교 해외 전파 된 것 아니라 성경 자신 들 입맛 맞게 해석 해서 사이비 같은 사람 들 많습니다  착실한 목사 님 들은 인정 못 받는 우리나라 개신교 종교 인정 되야하나 의 구심 드네  헌금 십일조 도 예수님 구약 나쁜 법 신약 하지말라 했지만 헌금 반 강제 적 하는 곳도 많고  예수님 이웃 먼저 화해 예배 참석 하 했지만 무슨 예배 안 하면 죽 사람 코로나 퍼지고 이웃 하지말라 말려도 예배 참석 하려는 사람 들 진정 성경책 제대로 이해 예수님 따르는 건가	FALSE
또 교회 문제 네  아 휴 종교 단체 제일 잘 지켜야 하는데  그러면서 신은 왜 믿 읍	FALSE
교 모두 무인도 보내든가 죽여라	FALSE
조선인 들 에 한번 씩 패 않으면 말 듣지 않는다	FALSE
M 이상 거리 두고 설교 하는데 뭐 문제	FALSE
유독 기독교 탄압 하는 독재정 권  부정선거  코로나 방역  문 재앙 이제 영창	FALSE
그럼 방송 할 때 연기 할 때 다 들 마스크 쓰고 말 해야죠  방송국 코로나 없나요  목사 님 설교 하시는 곳 교인 들 m 이상 떨어져 있습니다 제대로 알 교회 다녀 보고 기사 쓰던지 하세요  사람 들 말 하는 장소 다 위험성 있는데 이렇게 굳이 국민 들 특정 종교 대한 감정 생각 안 좋아지게 언론 보도 하는 이유 뭔가	TRUE
모조리 확진 되서 죽어라	FALSE
목사 목 사 몫 사 했네  ㅋㅋㅋㅋㅋㅋㅋㅋ	FALSE
기독교 탄압 하지 마라  천벌 받는다  무슨 코로나 기독교인 걸리나  코로나 이야기 하면 기독교 나와  처음 코로나 발생 했을 때 중국 입국 금지 시키지 않아서 퍼뜨려 놓고는  누구 탓 해  광복절 때 연휴 만들어 놀러 가라 한 게  누군데 자기 들 잘못 인정 안  그저 누구 탓 해 이 인간 들	TRUE
공산주의 싫어요  주사파 토나옵니다	FALSE
이 정도 기독교 반 사회 단체 규정 해야 할 듯 이 기적 민폐 상업 집단	FALSE
떨어져있어도 설교 자 마스크 착용 해야 함  비말 튀어 어디 떨어져 붙어있는지 알 뭔가	FALSE
교회 이해 못 주 구 장창 욕 하다가 저번 준가 친구 기다린다고 따라갔는데 왠만한 코노 음식점 더 철저해요 손소독 열 체크 비닐 장갑 거리 둠	TRUE
참나 그래도 착용 해야지 언 개 솔이	FALSE
개신교 뭔 교 이단 아니면 사이비  모이 말라면 모이 마소  설교 안 듣고 집 기도 하면 된다 모범 되 야할 종교인 아 나무 인 날뛰니  코로나 친구 맺 엊 요 한 심다  신앙 마음 하는 겁니다	FALSE
기도 해 아저씨 집 구석	FALSE
나이트클럽 사장 교회 먹사 👽👽👽  교회 좀비 들	FALSE
마스크 쓰고 설교 하라 이건 너무 한 것 아닌가요 뭔가 상식 적 문제 있습니다 뉴스 진행자 마스크 쓰냐 이제 너거 끼리 살아라	FALSE
여태 하는 짓 보고 그 소리 나오냐  이번 코로나 일로 교회 이 기적 모습 보였는데	FALSE
사실  교회 개독 종교 거리 두기 역행 했고  전광훈 보수 정치인 주도 적 전파 공이 크므로 죗값 치르는 중  마스크 쓰기 싫으면  물건 너 왜놈 들 살아라	FALSE
전염 될 일이 있으니까 교회 방역 수 칙 지키라는 거 아니겠니 아가 마스크 쓰면 벼락 맞아 죽니 교회 전파 주 범 맞아 평소 안 보던 사람 들 집단 집중 된 시간대 만나고 큰소리 노래 부르고 하는데 위험하지 그럼 대면 예배 허락 해줄 때 좀 잘 해라	FALSE
그러네요 동감 합니다	FALSE
수어 통역 얼굴 표정 포함 되기 때문 마스크 쓰지 않는다고 매체 여러 번 나왔음 무식	FALSE
설교 때 밥 쳐 먹으면서 하냐	FALSE
방송인 들 보면 서는 어찌 생각 하십니까  티비 보면서 무섭지 않던가요  마스크 들 안 방송 하던데  방송국 사람 들 코 나나 전염 안되는 괴물 보이시  편향 적 사고 버리시고 상식 적 합리 적 생각 합시다	FALSE
전광훈 목사 님 알 나 그런 소리 하시지요  나라 공 산화 되어가고 교회 탄압 받는데 그런 것 느끼지도 못 하 거나 외면 하는 분 들 가짜 요 정치 방역 하는게 누군데 정치 거짓 방역 안 하면 우리 대한민국 살아납니다	FALSE
티비 안보 시나 보네요 방송 하는 사람 들 마스크 안 방송 합니다 방송국 사람 들 코로나 전염 안되는 괴물 보죠  편파 적 사고 버리시고 상식 적 생각 합시다	FALSE
녹음 해서 립싱크 하면 되지요	FALSE
그러면 방송 다 잡아 거두세요 방송 도 마스크 안 방송 들 하니까 편파 적 사고 버리시고 상식 맞게 생각 하세요	FALSE
힘들더라도  마스크 끼  해야지	FALSE
ㅉㅉㅉ 너 잡아다 감방 행	FALSE
나도 북한 공산당 싫어요 태 영 호도 싫고	FALSE
반 사회 적 집단 문재인 정권 임 거짓 디 범벅 완전 사기 집단 임 문재인 정권 없어져야 자유 대한민국 삽니다	FALSE
와 중국 이슬람 제압 하네 중국공산당 대박 무섭네 ㄷㄷ	FALSE
중국 북한 일체 종교 금지 하는 것 잘 하는 것 같다  종교 백해무익 영혼 좀 먹게하는 마약 말 맞다	FALSE
모든 강대국 거친 일이 긴 하지	FALSE
천연자원 때문 강제 지 들 땅 우기고있는게 섬나라 원숭이 들 똑같아 지구 상 없어져 야할 인족	FALSE
괴독교 싫지만 이슬람 싫다  이슬람 싫지만 중국 싫다  중국 싫지만 일본도 싫다  일본도 싫지만 적폐 들 더 싫다  언론 개혁 검찰 개혁 사법 개혁 국민 짐 초 전 박살 이루자	FALSE
불쌍한 위 그루 사람 들 ㅠㅠ	FALSE
Is 도 중국 안 건드리네 ㅋㅋ	FALSE
시진핑 내년 이슬람 피살 당하는거 아녀	FALSE
ㅋㅋㅋ 전세계 이슬람 테러 조직 발끈 하는 소리 나 들리냐 ㅋㅋ	FALSE
모든 이슬람 무장 세력 들 is 포함 해서 중국 공격 해야되 지 않나	FALSE
ㅋㅋ 서방 세계 무슬림 전쟁 무슬림 대 중국 전쟁 바뀔거 같은데 느낌	FALSE
냅 둬 무슬림 원한 사면 피곤해질 게다 우리 문제 생기겠구나 외형 구분 안되어서	FALSE
무슬림 모택동 섬기라는 것  무슬림 사원 모택동 사진 걸고 알라 기도 하 것  그 다음 시진핑 걸리겠지  IS 가 중공 활동 영역 이동 하면 미국 도와줄까 모르 채 할까  인구 많고 땅 넓은데 중공 활동 하기를 바 본다	FALSE
무슬림 공산당 지독하기로 따지면 막사 악하다 인간 대한 예의 없고 당 알라 대한 맹목 적 강요 있다	FALSE
문 재앙 기독교 탄압 같구만	FALSE
우상 즉시 치우세요 종교 핑계 악마 제 욕망 충족 시키는 이치 종교인 성직자 중 속 들어가는 마귀 왜 깡패 속 들어가는것 보다 사람 도망 못 가게 경 계심 못 가지 협박 하기 딱 좋아 마귀 들어간 목사 무당 부모 옆 있어도 안수 기도 한다고 때려 죽 계속 일어나니 큰일 종교 전쟁 악마 성직자 종교인 속 들어가 일으키는 전쟁 역사 반복 합니다 이슬람 테러 집단 이상 우상 보내세요 난민 더 받으면 망합니다 외국인 한국 국적 가진 외국인 투기 꾼 보내야 재앙 멈춘다는 예언	FALSE
터키 뭐 하냐  같은 투르크족 무슬림 위구르족 탄압 하는 중국 단교 해야 투르크 맹주 터키 할 의무 아닌가  에르도안 투르크 이슬람 맹주로 중국 단 교하	FALSE
근데 이 시국 중동 성지순례 못 가게 하는게 맞지 아닌가	FALSE
전 세계 무슬림 들 뭐 하냐  무슬림 전부 형제 라며  그냥 두고 볼거야  니 들 잘 하는 거 있잖아 중국 서 테러 하고 그래라	FALSE
이 시국  이기 종교 탄압	FALSE
한족 이 탐욕 떼거리 족속	FALSE
좌 우 이념 떠나서 사람 생명 소중하며  사람 인권 가장 기본 적 보편 적 치중  중요한하나의 요소  그런데 중국공산당 통치 하고있는 중국  인권 있던가  위구르족 티벳 탄압 물론 파룬궁 탄압 강제 생체 장 기적 출 만행 등등  이런 천 인공 노 할 짓을하고 있는  인권 탄압 학살 악의 원흉 중공 이번 한국 전 폭 적 지원 지지 받고 유엔 권리 사회 상임 국 선출 되어 진출 했다  인권 학살 탄압 국 유엔 인권 상임 국 선출 됨이말이되 는가  더욱더 인권 탄압 하라 한국 중공 지지는 독사 물을주어 사람 해치 하는것과 같은 악의 편 것 같다  결국 이번 잘 못 된 결정 한국 역병 이창 궐 할것 임	FALSE
중국 입장 종교 자유 억압 하는 것 당연하다 종교 자유 있으면 그게 민주 자유 국가 공산 독재 국가 아니다	FALSE
중국 유일하게 잘 하는 일  이슬람 박멸	FALSE
더듬이 당 만세	FALSE
ㅍㅎㅎㅎㅎ 간만 웃겼다  기독교 탄압  코로나 때문 대면 예배 금지 것 때문  너 참 재미 지다 ㅍㅎㅎ	FALSE
하나님 까불면 죽는다고 협박 하는게 기독교 싸이코 컬트 ㅋㅋㅋㅋㅋ	FALSE
개신교 탄압 찬성  현 정권 코로나 대책 탄압 하는건  그냥 뇌절 궤 소리  응 당신 뇌 좀 그만 탄압 해요	FALSE
탄압 뭔 줄 아니 ㅋㅋ 찐 따	FALSE
나 대대로 기독교 아들 교회 끌 가는데 전광훈 같은 사이비 정비 못 죄 크긴 하지	FALSE
마님 부르 신다	FALSE
당신 들 종교 믿는게 아니라 그 전씨 믿는거잖아  무슨 종교 탄압	FALSE
그건 그런데 쟤 들운 걍 핑계	FALSE
현 정부 불만 있으면 태국 배트 남 귀 화해 개 so 리줴치지	FALSE
니놈 바로 공산당  민주주의 국가 발전 위 비판 울 할수있지  발전 위 비판 할수 없는 이 바로 공산당  무식한 내 로남불 들  곧 친중파 들 모두 역병 쓸어 버릴것이다	FALSE
아 불사조 새벽 잠도 안자면서 지 댓글 체크 하는구나 하긴 박상학 이 밤 풍선 띄워놓고 새벽 많이 gps 체크 했었지	FALSE
여기 훈련 받아 보았는데 비젼 캠프 시간 보통 명 한꺼 번 모인다 숙식 함께하고 다닥 붙여 앉아서 소리 높여 찬양 기도 한다 박 을 꼬박 집회 하면서 그렇게 한다	FALSE
지긋지긋한 개신교	FALSE
정신 줄 놓은 사람 들 정말 많네  이 시국 명 핸드폰 끄고 이 거 뭐 하는 겁  하 진짜	FALSE
그러면 귀 닫으세요	FALSE
원래 완벽한 인간 없 음 본인 신 생각 하신다면야	FALSE
도대체 이나라 얼마나 많은 교화 들 많은 겁 교회 탓 하지말고 미리 절단 내세 천주교도 지금 난리 입니다 성 모 병원 들 장례식 장 조사 나 가보세요 노 너 하러 떼거리 몰려 다닙니다 사무실 항의 하면 어쩔 수 없다네 삼성 아예 출입 금지 성 모 계열 어쩔 수 없다 헐	FALSE
이 곳 다녀온 후배 만 낫다  몇 년 만 낫다  점심 하자 식당 들어가 음식 나오자  하는말이 상주 종교 집회 다녀 왔다고  말햇 다 참으로 열 받앗다  이런 종교 쓰레기 들 참으로 뻔 뻔해서 할말을 일 바로 또 나서  안성 보건소 열 락 하 보건소 향햇 다  보건소 직원 참으로 한심했다  방역 예방 먼저 아닌가  예방 차원 시간 내서 그리고 내 자신  기 저 질환 환자 참으로 조심 히 살 가는데 안성 보건소 한심하다  나중 확 진자 판칠 때 그때 나설것인가	FALSE
사이비 임	FALSE
모이 말라는데 왜 모여 ㅋㅋㅋㅋㅋㅋ 단계 올려도 안 지킴 걍 단계 없애라 ㅋㅋㅋㅋㅋ 알아서 들 지 몸 지켜서  오래 살아라 살고싶으면	FALSE
왜 제주도 없을까 강릉 나오면 제주도 있을껀디	FALSE
단계 올려라	FALSE
내 이럴줄 알았다니까  다시 단계 해  이제 곧 겨울 호미로 막을거 가래 막지 ㅠ  근 시안 적 생각 하지 멀리 내다보면 안될까 요	FALSE
다시 단계 격상 하자	FALSE
명 이하 아닌데 거리 두기 단계 내린것이 이해 안가네요 정해진 기준 무시 하는 중대 본의 고무줄 결정 어케 이해해 하나	FALSE
제발 치료 좀 해주지 마  자꾸 치료 해주니까 정신 못 차리고  또 수련 회하 모임 하자나요  하느님 그렇게 믿으면 하느님 치료 해달라고하라 해  다 가 뒤 두고 못 나오게 해주세요	FALSE
또 교회  진짜 어 ㅇ 가 없네  교회 차단 하세요 제발 부탁드려요  또 자영 업자 들 건드리지말고  역겨우니까	FALSE
단계 단계 더 위험한 이유 방심	FALSE
해외 유입 확 진자 들 입국 금지 하 불법체류자 들 강력 단속 해서 전부 추방 하 깜깜 무증상 감염 불법체류자 들 강력 단속 해서 전부 추방 하 조선족 중국 외 노자 들 전부 돌려 보내라	FALSE
해외 유입 오는 족족 확진 안막	FALSE
좀 많이 힘들겠지만 ㅜ 아직 은 단계 낫다 ㅜ	TRUE
단계 개인 위생 마스크 방역 단계 입니다  그리고 제발 말 좀 들읍시다	FALSE
저 놈 종교 뇌 없나 봐  진짜 모 지리 들  지옥 언 능가  코로나 합병증	FALSE
제발 쫌 지킬껀 지키 자구 요양 병원 계신 아버님 면회 좀 할수있게요 너무 그립고 어찌 지내시는지 미치겠답니다	FALSE
연휴 지나고 잠복기간 점차 지나가니 확 진자 다시 급증 있습니다 이럴 때 더욱 신중히 행동 조심해야 한다고 생각 합니다 모두 개인 방역 수 칙 지키고 자택 머무르는 등 조금 더 노력 한다면 이 사태 빠르게 지나갈 수 있을 것 생각 합니다 다 들 조금 더 힘내 봅시다	FALSE
교회 진짜	FALSE
코로나 끝날 때 교회 폐쇄 해주세요 어린이집 휴 원 좀 하세요	FALSE
이러다가  거리 두기 또 단계 겠네  마스크 착용 최고 방역 입니다	FALSE
다시 단계 하 뎐 단계 격상 하자 ㅠㅠ 정부 제발 봐	FALSE
외국인 명 이 던데	FALSE
연휴 지나고 잠복기간 점차 지나가니 확 진자 다시 급증 있습니다 이럴 때 더욱 신중히 행동 조심해야 한다고 생각 합니다 모두 개인 방역 수 칙 지키고 자택 머무르는 등 조금 더 노력 한다면 이 사태 빠르게 지나갈 수 있을 것 생각 합니다 다 들 조금 더 힘내 봅시다	FALSE
왜 아직 외국인 무상 치료	FALSE
어제 해외 유입 늘어난거던데	FALSE
좀 제발 아 진짜 징글징글 하다	FALSE
이런데 아이 들 학교 전교생 등교 하 미친 짓	FALSE
담주부터 초등 등교 매일 입니다    이 말 되나요	FALSE
떼거지 모인 사람 각자 치료 비 받아라	FALSE
아 제발 좀 교회 욕좀 그만 먹이 하지말라면 하지마 제발 진짜 답답하다 제발 좀	FALSE
코로나 지긋지긋하고 징글징글  개독 병균 덩어리 들	FALSE
하느님 믿는 바보 님 들  지구 둥글다고 했다 죽임 당하고 지구 돈다 했다고 종교 재판 하고 이런 것 보고 아직 교회 다니는 어리석은 사람 들  생각 좀 해봐요 시장 가서 과일 살때 살펴보고 따져 보면서 인생 가치관 결정 하는 종교 교리 왜 따져 보지 않 읍 믿음 강조 하는것 들은 다 사기꾼 입니다 입증 하지 못 하니까 믿으라고 강요 하는 겁니다	FALSE
문제 정말  그 랫 놓고거리 한 단계 내리구  학교 수업 들어가고  날리다 더 커진다  단계 내리면  큰 학원 대형 그런 곳 영업 들어간다고	FALSE
교회 이제 정말 싫다	FALSE
아 지겹다 지겨워 곧 고 수능 수험생 들 생각 안 하냐 백신 언제 나오냐 ㅠㅜ 이 젠 지 칠 라그 진짜	FALSE
다시 단계 격상 시킵시다  단계 너무 이른 발표 였음  이 젠 인원 제한 집합 금지 해제 시켰으니  더 나오면 더 나오지 줄 진 않을꺼 같아요  다시 수정 하시는게 또 타이밍 못 맞춰서  단계 가야 할지 고민 하지말고	FALSE
예상 했으나 힘 떨어지네요 다시 단계 가야되 나	FALSE
아니 계속 퍼지고 잇는대  단계가말 입 방구 ㅡㅡ	FALSE
담주부터 초 매 일 등교 랍 다	FALSE
격상 하면 뭐 해 말 안 들어 정말	FALSE
수련 회 ㅠ  왜	FALSE
단계 노래방 가는 사람 있더라 뇌 있냐	FALSE
상황 나아진 기 없는데 왜 단계 낮췄는데 이해 할 수 없다 ㅉㅉ 숫자 장난 하냐	FALSE
초 중 은 코로나 절대 안 걸리고 교회 밀집 높아도 학교 매일 등교 강요 이상한 코로나 일세 코로나 사람과 정소 봐가며 전파 되나	FALSE
추석 지나고 단계 좀 에바 아니냐  머 리가 있으면 생각 해봐라 문디 제스 터	FALSE
다시 단계 올려도 모자랄 판 단계  선심 쓰기	FALSE
저 봐 단계 선포 한지 하루나 지 낫 너무 앞서가는것 같다 햇 ㅠ	FALSE
정국 시작 된 코로나 진짜 그러고 지 들 코로나 없어졌다고 집단 모임 들 갖고 중국 형벌 내려라	FALSE
이런데 단계 갈 때 보자는 건가	FALSE
종교시설 제발 수련 회 좀 하지마라	FALSE
교회 목사 들 문제 호데 구상권 청구 하 아직도 정신 못 차린 이간 들 많다	FALSE
제발 해외 입국 자 차단 해라 쫌 중국 다시 확진  자 나왔다며 중국 차단 해라 그래놓고는 무  슨깜깜 확진 속출 하네 쇼 하지말고 제발 중국 좀 막아라 거기 중국 흑사병 돈 다  던데 제발 들이지 좀 마라	FALSE
오 바하 마라 해외 유입 생각 해라 무능한 정부	FALSE
여러분 전광 후니 순교 했나요 확인 안되네 ㅠㅠㅠ	FALSE
미 춰 버리겠다	FALSE
해외 입국 제한 못 하면  국내 감염 자수 절대 줄어들지 않습니다  왜 거리 두 만 강요 하나요	FALSE
종교 왜꼭 가야 하나 참 정말 나이 드셨으면 나이 값 해야지 다시 전쟁 때 돌아가야 종교 빠진자 들 정신차리겠나 에이 구 그렇케 하느님 예수님 믿으시고 예배 하면서 죄책감 도 없지 배려 기본 아닌가 ㅋㅋ 기본 못 지키면서 멀 다니는 건지	FALSE
구상권 청구 하세요 꼭 ㅜㅜㅜ	FALSE
사흘 동안 수련 회 말 되나  지금 같은 때	FALSE
제발 좀 자제 합시다 후손 들 위해 어린이집 아가 들 어찌 하	FALSE
교회 다니는 사람 들 증오 스럽다  더럽게 말안 듣는다 진짜  교인 소리 들어도 치가 떨리고  소름 돋는다  교회 교자 보기 듣기 싫다  어지간히 좀 해 인간 아닌것 들아	FALSE
교회 수련 회 해서 세뇌 지속 적 해야 믿음 지속 되는 겨 다단계 합숙 시키는거랑 비슷한 겨 왜 자신 없어	FALSE
갑자기 단계 뭥미  갑자기 전체 매일 등교 하  뭐 어쩌라고	FALSE
교회 철문 꼭꼭 닫아주세요 아멘	FALSE
이런데도 단계 교회 감염 된 사람 들 각자 치료 비 부담 하는 법 만들어 주세요	FALSE
코로나 완전 종식 될 때 단계 낮추면 안된다	FALSE
또 교회  사탄	FALSE
멀미 난다	FALSE
얇아도 너무 귀가 얇은 정부 곳곳이 지뢰 밭  단계 금새 내 리더 확진 엄청날거 같네	FALSE
대전 우리 집앞 교회 예배 끝나고 점심 먹고 찬송가 우리 집 들리게 우렁차 찬송 부르고 아이 들 교회 앞 놀이터 모여 놀고 주일 그 들 즐기는 날인 봅니다	FALSE
모이 말 그렇게 신신당부 했는데 ㅜㅜ  벌금 내야 정신 차릴듯 싶 읍니  법칙 것 지켜 야하는것  바이러스 감염 엄중하게	FALSE
이 시국 교회 수련 회  얘수 님 그러라고 가르치던	FALSE
소 모임 금지 했는데 모였으니 처벌 해야지     물렁한 처벌	FALSE
해외 쫌 막아라 제발	FALSE
이제 넘 지쳐서  코로나 뭐 학교 좀 갔음 좋겠습니다	FALSE
수련 회 터졌 다자 아오	FALSE
단계 하루 참 대책 없네 정부 보고있나	FALSE
정부 제대로 못 하 그렇지 북한 김정은 데려와라 김정은 한마디 말안 들으면 바로 총살 시켜 버리게 이나 민주주의 문제 아니다 이럴 땐 총살 시키는게 답 미국 경찰 들 데려와서 강제 진압 해서라도 막아 야한다 몇 십년 몇 백년 때릴수있게 판사 데려와라 한국 윗 대가리 들 전부 물 갈이해 야한다	FALSE
독감 백 신도 없는 마당 초 등등 교 매일	FALSE
다른 거 덮어놓고 문재인 이 문제 문재인 이 저 자리 내려오전에는 코로나 절 대안 없어진다니까 사람 이 어떻 게집 들어 앉아있나 시장 가야 맡도가야하고 직장 가야 돈 도벌 먹고살지 믄 재인 가 저 자리 내려와야 끝 이난 다 고문 재인 가 자꾸 끌 고오 데 없어지나 아무 탓 도안 문재인 탓	FALSE
광화문 산성 쌓더니 반 문 집회 못 하게하면 코로나 사라지나요 기자 님	FALSE
바로 격리 하자나요 무조건 막는게 대수	FALSE
다 막으면 경제 죽어요 들어오기 전 자가 격리 하고 오 괜찮아요	TRUE
자가 경리 개뿔 해외 입국 자 들 검사 직전 해열제 먹고 들어 와서 코로나 필터 링 의미 없는 거 봐 야한다	FALSE
어린이집 단계 일 때 휴 원 이었습니다 다만 조건 없는 긴급 보육 받기 때문 아이 들 많았죠 ㅎㅎ 맞벌이 부부 생각 하면 어쩔 수 없지만 가정 주 부들 너 도나 맡기니 더 복작복작 할수 밖 ㅠ	FALSE
외국 유입	FALSE
그럼 외국 수입 하는 모든 물건 금지 해야 맞는데 가능할거라 생각 합	TRUE
왜 정부 탓 좀 풀러줘다고 그걸 악용 한 사람 잘못 특히 종교 단체 좀 좋아져 서으니 서로 조심 하 보고 한 겨 뿐 그대 그걸 이해 못 하구 응 니 네 이리 이렇구 했자 나하 핑계 뿐	FALSE
도대체 교회 말 죄송하다고 하고  행동 위선 적  목사 들 솔선수범 해야 하는데  말 전광훈 잘 못 이라하고  목사 제적 하지도 않네  같은 부류 거지  지금 코로나 종식 위 기도 하는데  진짜 종식 되면 기도 종식 되었다 하겠지  진짜 개념 없다  노답  노목	FALSE
집회 지인 모임 종교 활동 위험 요소 꼽으면 수 만 명 제주 찾은 것 대하 여 어째 한 마디 없냐 나훈아 KBS 방송 당부 하더 린 국민 소리 제대로 전하 방송 되라고 몇 시간 되었다고 kbs 는 정부 하수 노릇 하냐	FALSE
웬 갑자기 종교 모임  제주도 명이 다닥다닥 붙어 앉아 비행기 타고 오고 간건  티비 트롯 콘서트장  만만한게 종교	TRUE
그럴 싸 해보이는데 왜 제주도 여행 얘기 쏙 빠졌나	TRUE
ㅋㅋㅋㅋㅋㅋ 트로트 콘서트 막아라 ㅋㅋㅋ  한심한 정권 진짜 미개하 닼 ㅋㅋㅋㅋㅌ	FALSE
전철 만원 들 코로나 전철 왜 없는지 의아 하 답 더	TRUE
미스터 트롯 콘서트 보고 말 잃었다  집회 반대 할 명분 있을까 없다고 본다  집회 해라 단 마스크 쓰고  매 일가 회사 식당 지하철 그리고 여행가 제주도  이슈 한번 없고  표현의자유 중요한 집회 자기 들 불리하니 막는다	TRUE
미스터 트롯 콘서트 보고 말 잃었다  집회 반대 할 명분 있을까 없다고 본다  집회 해라 단 마스크 쓰고	TRUE
정치 코로나 정권 입맛 방역 아직도 모르는 사람 모르고 싶은 대 깨문 뿐	FALSE
휴가 끝 갑자기 종교 탓 시작  이 정권 언론 통한 남탓 프레임 짜기 전술 주 특기 군 놀라워라 그 솜씨	TRUE
매일 밥 먹는 식당 카페	FALSE
집회 하면 캥 기는게 잇는게 지  그 래서 어 케 막는거지  교회 서도 바른 말 하  어케 못 모이 하는거지  코로나 살리는 문 정권	FALSE
무엇 두렵길래 이 것 저 것 다 막고 못 하게하는건 가요	FALSE
도데 체 이해 안되는건 집회 왜 하는 건지 ᆢ 그리고 귀가 따갑도록 모이 말라하면 모이 마라	FALSE
제주도 관광 명 기자 공항 가봤니  거리 두기 찾아봐  출국 장 검색 대 승 합장 심지어 게이트 통과 시 거리 두기 안해  쇼핑몰 어떻구 가봤잖아 ㅎ  쇼핑몰 보통 이상이다  전국 쇼핑몰 백화점 모이는 수 당 일로 몇 명인 알고있니  광복절 집회 참가자 수 될껄 종교시설 왜 뻑하 말애 요즘 잘 예방 있는데  교회 전국 곳  잘 협조 하 잔  기껏 모여 봐야  주일 한번 이야  그만 탄압 해  개시 보건소 곳  하루 평균 명 검사 있다  왜 검사 수안 늘리는건데	FALSE
또 프레임 씌울 준비 하나  전국 퍼지는데  결국 은  집회 종교 단체 체육 시설 등  퍼진다  K 방역  기준 없다	FALSE
종교 집회 왜 나와 미친 방역 정권	FALSE
기자 교회 두 달 째 비 대면  모 예배 못 드린지 한참 된거  니 모르냐	FALSE
제주도 여행 왜 놔두냐 미친 정부	FALSE
방역 쓰고  국민 들 공산주의 길들이기 읽는다  통계 못 믿겠고  확 진자 몇 명 하지만  그것 못 믿겠고 진단 키트 엉터리 하고  진짜 공산주의 바보 사상 인증 된 걸 강요 하냐  중국 북한 거지 국가 사는거 봐라  우리 그 들 구질구질한 기생충 숙주 살기 싫다	FALSE
집회 모임 종교 활동  개코 같은 소리 하고있네  공항 쇼핑몰 백화점 훨씬 더 심각하다 기레기  차라리 인 차량 개천절 집회 훨씬 더 안전하다	FALSE
코로나 정치 진짜 정권 교체 반드시 해야 합니다	FALSE
불리하면 확 진자 올렸다 내렸다 장난 치지마라 식당 커피 숕 전철 버스 그렇게 사람 많은데 확 진자 안 나온다 참 이상하지 다 조작 같다	FALSE
아니 코로나 누구 때문  추석 부모님 안 찾아 뵙고 여기저기 놀러 가는것은  개천절 집회 무슨 코로나 발열 날짜  종교 코로나 방역 최대 힘쓰는 곳 주 범 ᆢ  그냥 인간 한계 일 뿐 ᆢ  베이커리 까페 ᆢ  식당 가봐라 ᆢ  그냥 다닥다닥 ᆢ	FALSE
이 정부 감출 게 많은가 봅니다 정치 방역 너무 티나	FALSE
집회 자유 보장 하  전철 운행중단 집회 그만해라 말 해라 이 것 들 무슨 방역 한다고  이 공정한 정의 민주 국가  지금 광화문 인도 철재 구 조물 미로 만들어서 밀접 접촉 하 만들고 있다 그 돈 누가 대고  누구 돈 문 통 개 돈 아니겠지  광화문 반정부 국민 집회 사전 통제 하겠다  한번 경험 하지 못 나라 인민 민주주의 공화국 잘 만들어가는 것 같구나 이 인민 들  주사파 공산주의 떨 거지 들  부정 선거 신고 된 곳 재 개표 안하냐  자신 없냐 지금 몇 달 째 미루냐  국민 속 일수 있다고 생각 하느냐	FALSE
니 들일하 때 안 위험하냐 말 갖다 붙이는게 기레기	FALSE
지나면 확 진자 또 명 명 올라가겠지 ㆍ 뻔 하잖아 ㆍ 집회 문 대통령 얼마나 욕 하는지에 따라 잡아들여야하니까 ᆞ 만약 문 정권 찬성 하는 대규모 집회 한다면 괜찮겠지만 ᆢ	FALSE
내일 이 기사 낸 기자 전화해야겠다  무슨 정보 종교 활동 넣었는지  대 위험 요인 같은 소리 자빠졌네  국민 개돼지 바보 아	FALSE
끊임없이 유입 되는 해외 발 코로나 환자 들 어쩌구 총 환자 몇 인지 따져 보면 현 방침 쉽게 납득 하기 어렵습니다	FALSE
요 댓글 죄다 보수 꼴통 들 있나	FALSE
이렇게 많은 사람 들 정부 하라 데 따르고 했는데도 일부 소수 사람 들 인해 코로나 계속 확산 된다면  계속 반복 k 방역 같은 소리 그만하고 사람 들 살 수 있게 방역 방법 좀 증상 있는 사람 대응 하게 좀 바꾸고 사람 살 수 있게 해줘야지 온통 못 하게 규제 정지 한다고 되는거 아니잖아 아직도 해외 유입 계속 되고 있는데 왜 자 국민 들 전부 못 하게 막고 자빠졌냐	FALSE
Kbs 정신차려 ㆍ 언제 하수 할거니	FALSE
지난 번은 확실하지 않다고 하더니  언론 정부 다시 조작 시도 중	FALSE
비 대면 최고 방역 입니다 제사 음식 이제 현대 식 바꾸어 나가죠 절 해 바 소용없습니다 음식 쓰레기 힘들 뿐	TRUE
코로나 인간 같이 가는 삶 굳어진다고 보면 됩니다 솔직히 중국 군사 무기 만들어 퍼트 린것 아닌가 미 중 무역 전쟁 코너 국가 위기 처 하 자국 희생 감수 퍼지게 만들었다고 미국 말 하지 않는가 우리나라 나와 다른 약자 국가 중국 눈치 보느라 감히말도 못 꺼내는 처지 아닌가 인긴 이 만든 병원체 접종 약 이나 치료 약 나올 즘 다시 변종 되풀이 해서 인간 지배 및 정복 불가능해서 인간 삶을같이 하는 코로나 봐 야합니다	FALSE
고 위험 군 종이 풀어라 의미 없다	FALSE
가까운 사람 들 서로 위해 안전 유지 해야하는거 아닌가 모임 갖고 죽어도 좋다는 식 대면 하는 건가	FALSE
지하철 업무 공간 등 불확실한 공간 들 조심해야 해	FALSE
맨날 불리하면 모임 금지 공산당 들 하는 짓거리 그대로 하고 있는데 이 걸 왜 좌시해 야하는지 이해 안 갑니다	FALSE
오늘이 토요일 코로나 시국 집회	FALSE
에버랜드 가보게	TRUE
기 승 전 종교	TRUE
고령 층 보호 개법 수원 만 봐도 같은 영업 형태 운영 하는 노인 무도장 영업 허락 해 주고 노인 콜 라텍 안되고 뭐 이런 개법 어딧어 정부 더 감염 확산 시키고 있다 방역 취지 걍 물 건너갔 댜 떨 아이 들 다 죽자	FALSE
https://www1.president.go.kr/petitions/592823	TRUE
사람 들 외출 등교 자제 하시고 집 머무르세요 코로나 이겨내시고 응원 할 수 있어요 의료 진 들 화이팅 하자	TRUE
법원 딴 나라 소속  마치 대한민국 조건 부 테러 허가 했구나  어리석은 것 계획 것 답답히네	FALSE
끼리끼리 족 들  우리 아니면 돼 족 들	FALSE
자동차 시위 금지 코로나 확산 우려 X 부정선거 들킴우려 O	FALSE
‘ 주식회사 예수 신천지 포함 가 살아서 설쳐 대는 한 코로나 사라지지 않는다	FALSE
단계 갑시다	TRUE
또 개천절 집회 다 핑계 되겠군요  완전 박정희 독재정치 독재 아니다	FALSE
하지말라는 것 좀 하지 말 자 징그런 것 들 ㅠ 너무 자유도 힘들어	FALSE
교회 개천절 집회 가지 마시고 코로나 진정하시고 감정 가라앉히고 이겨내시고 극복 하게 의료 진 들 화이팅 하자 빨리 끝내자	TRUE
개돼지 아니고 그만 집회 하	FALSE
헌법 보장 집회 결사 자유 코로나 핑계 탄압 하는 문재인 방역 수 칙 지키도록 유도 하는게  바른 정부 자세이건만  무조건 탄압 하는 문재인	FALSE
코로나 여당 잘못 비판 더 무서운듯	FALSE
같은 생각 하는 사람 들 있구나 그러게요	TRUE
여기 대 깨문 들 천지  조심해요  댓글 한 달 간 정지 먹음  감빵 간 박근혜 이 정도 아님  진짜 안철수 말 평생 겪어 보지 못 한나라  살 함 진짜 누가 건 들 이제 폭발 할거 같음	FALSE
아직 모르겠지 니 들 하는 짓 봐라 뭔 생각 하겠냐	FALSE
이 정부 특기 잖아요  덮어 씌우기 ㅎㅎ	FALSE
강 춘 이씨 이런 댓글 더 놀랍네요  언론 통제 다른 정권 때 더 심했다고 생각 합니다만	FALSE
확 진자 실제 비율 따져 보면 카페 식당 모두 순위 권 밖	FALSE
밥 같이 먹을 때 제일 위험 집회 마스크 끼 했지만 끝나고 밥 먹고 간식 먹고 해서 더 위험했다 또 오가는 차 안 도	FALSE
궁금해서 질문 드립니다 교회 바른 말 한다고 하셨는데 그게 어떤 말 설명 부탁드립니다	FALSE
의도 파악 많이 어려운 가보네요 그냥 하고 싶은거 다 하시고 뒷일 스스로 알아서 책임지세요	FALSE
우리 집압 교회 주전 예배 보던데 몬소리	FALSE
확 진자 팩트	TRUE
졸리 자라 횡설수설 하지말고	FALSE
보수 꼴통 이  좌파 북한 추종자 들	FALSE
중국인 시민 들 종북 김정은 바라기인가	FALSE
요 노무 새끼 니 균 퍼뜨렸구	FALSE
독재 도무지 뭔 지 모르는건  아닐텐데 어째 그 요	FALSE
사람 집회 하는거다  개 돼지 내 편 맞다고 무조건 빨 아대 꼴통 들이지	FALSE
개돼지 너 머냐 소 새끼	FALSE
헌법 집시 자유 있냐 국민 생면 권 국가 보호 의무 안 찾아봄 그리로 기본권 충돌 할 때 생명 권 상위 기본권 판례 못 봄	FALSE
은지 님 말씀 옳소	TRUE
이석기 석방 외치 자동차 시위 할 땐 왜 아무 말 못 했냐 코로나 확산 보다 대통령 정부 여당 비판 더 신경 쓰이는거겠지 탄핵 당할까봐 자업자득 될까봐	FALSE
댓글 한 달 정지 시키는거 보고 미친 정부 생각 했 음  전 두 한보 더한 좌파 정권  한반도 종전 ㅋㅋ  머리 돈거 같음	FALSE
일단 종교 모임 좀 자제 해라 그리고 지인 아니든 모이 말아라 그 래야 추석 확산 막을수 있다	FALSE
마스크 쓰 잔아요 교회 모임하면서 밥 먹는게 문제 지인 모임 하면서 술판 벌리다가 코로나 번 질수 있 잔아요	TRUE
중국 달 동안 지역 감염  미국 누적 명 계속 발생  코로나 는 무엇 중국인 미국인 구분 할까  미국인 인당 커피 소비 중국인 배이죠  중국인 태우지 않는 차  미국인 열매 태 우 는 ⟨ 발암 물질 발생 ⟩ 커피 주로 마시죠 연구 해보세요	FALSE
일련정종 불교 명 되고 교회 감염 되는게 아니네 성당 명 되고	FALSE
그만하자 자꾸 종교시설 가지 뭐라하지말고  다른 곳 돌아봐 이 빨갱이 들 ㅡㅡ  아주 교회 못 잡아먹어서 이러고 있는데 국민 들 바 본줄아냐 괜히 종교시설 탓 하지말고 술집 막아 그리고 생각 좀 하자	FALSE
대한민국 대통령 추미애 아들 이상직 임금 체불 윤미향 위안부 할머니 사건 박원순 서울시장 자살 사건 등 현안 대해 서는 입 꾹 다물고 뭔 소리 하시는지 문재인 뭐 하는 자입	FALSE
문 재앙 싫어	FALSE
가리 늦게 야단 법석 우한 폐렴 처음 수입 하지말지	FALSE
일본 재난 미 통 당 대구 경북 매우 슬퍼 할껍니	FALSE
문 정부 전광훈 추종자 들 구상권 및 사회 적 손실 손해 보상 법정 대응 해  또한 종교 세 추진 해라	FALSE
국가 전복 세력  테러 집단 일 뿐  교회 단체 같은 소리 자빠졌네  온 국민 분노한다	FALSE
너희 국민 탄압  너희 국민 자유 탄압  자 영업 분들 경제 목숨 탄압  멸종 종 들  사이비 너희 모 다르냐  하나님 교회 세우라 했더니  너희 교회 세웠구나	FALSE
느그 들 앞 목사 아니라 쓰레기	FALSE
전광훈 목사 나도 예수님 믿는 한 사람 정말 들도 목회자 아닌 사람 그러니 인간 들 하나님 믿는게 아니라 전광훈 믿었 구나 썩을 목사 들 대신 신학 똑바로 나왔는지 모르겠구나	FALSE
어휴 왜 들 그러세요 코로나 때문 힘든 사람 들 예수님 사랑 배려 위로 하지는 못 할 망정 제발 분별 력 좀 가지시길 개신교 인 부끄럽고 참담합니다 모두 죄송합니다	FALSE
그 한 일 들 성직자  합당 말  예수님 제자 들 정치 하라 했던가  목사 직 내려 놓고 우 좌  자신 정치 적 신념 말 하시길	FALSE
대한민국 기독교인 들의 생각 똥 없구나 그렇지 않다면 전광훈 이단 규정 해야 한다	FALSE
진짜 정신 병자 들 아니랍니까	FALSE
탄압 같은 소리 하네 아직 살아있는데 감사해라	TRUE
이 교단 전 총회 장이 전광훈 ㅋㅋㅋ  뭔 멍멍 이 소리	FALSE
사이비 화 되가는거 시 간문제  벌써 물이 많이 들었군	FALSE
박정희 땐 는 숨도 못 쉬고 충성 한 것 들 x 랄 들 하네  정작 젊었을 땐 돈 벌고 걍 먹고 살았던것 들이  나이 먹고 할 일 들 없으니 참 O 랄 들 한다  지 들이 뭐라고 애국자 코스프레 들 ㅋㅋ  정작 독재 시대 땐 비굴하게 살았던것 들이  독재 빨갱이 타령 있네 ㅋ	FALSE
세상 미쳐 돌아 가고있구나  지금 이 시국 어떻게 돌아가고 있는지 알면서도 현 정부 발목 잡기  대다수 국민 들 다 죽게 생겻  학생 들 등교 못  나라 전염병 때문 망하게 생겻는데  이 ♪♪ 은 도대체 머리 머 들은 거  헌금 받아서 처 먹고사는데 아무 지장 없고  배때 기름 껴서 얼굴 개 기름 흐르고  민주당 석 죽 쑤어 개주라고 만 들어준거 아니다  위 수령 선포 해서라도 이번 못잡으면  대한민국 소리 없이 다 죽는다 너 죽고 나도 죽는다  한번 죽기 살기 밀어 부치란 말	FALSE
앞 절대 교회 다니는 인간 들 상종 말아야 될 때 온거 같다	FALSE
종교 탄압 좀 해야 한다 어디 종교 국민 들 생명 위협 나라 망하게 할려고 하고 있네 대다수 국민 처벌 받길 바라고 있다	FALSE
개신교 목사 들 묻고싶다  지금 코로나 전국 자영 업자  학교 아이 들 등교 못 하는  마당 종교 탄압  당신 들 진정 하나님 말씀  전하 목시 인지 의문 스럽다	FALSE
잠시 쫌 지킵시다  온라인 예배 가능하고 그 곳  하나님 함께 하십니다	TRUE
전광훈 너희 들  국민 탄압  경제  자영 업자 생계 마 져도  파괴 한자 들  국가 국민 보호 하  너희 들 국민 수렁  밀어 넣는 파수 꾼 일 뿐	FALSE
기 막힌다 나도 기독교인    징글징글 하네 어쩌면 좋지 다 꼴불견 들 다니기 싫으네	FALSE
저런 놈 입 놀리고 다니는 자체 하나님 존재 하지 않는다는 것 증명 하는것이다 기독교 처음 인류 최대 사기 극 장님 눈뜨게 하기전에 니 눈 깔부터 고치 죽은 자를 살리는게 아니라 산자 정신병 자 죽은 자로 만드는 기독교 사회 암 신 믿으면 평화 와야하는데 전쟁 일으키면서 신의 가호 빈다 이런 정산 나간 종교 어디 있나 기독교 너와나 분열 시키고 사랑 보다 전쟁 분노 이기심 키우는 악의 종교 예수 온몸 못 박혀 십자가 죽은것은 그 죄업 따라 간것이다	FALSE
개신교 니 네 들 좀비 쓰레기 전락 중 종교 기능 성은 끝났다	FALSE
종교 뭔 줄 알 지껄이는지 목사 들 취직 할 능력 안 돼서 힘든 일 은하 기 싫고 사람 들 교묘하게 세뇌 시켜 돈 빼앗아 먹고사는 인간 들 종교 있긴하냐	FALSE
종교 사회 배제 시켜야되	FALSE
예수 이름 팔 정치 활동 하는 서북청년단 후예 들  지금 어느 땐 대 아직도 이념 몰이 장난 질 치  그딴 식 하니 젊은 세대 교회 떠나고 예배 외면 당하는거 아냐  보수 교단 아니고 수꼴 교단  백석 측 전광훈 목사 직 박탈 했는대 쫓겨난 가짜 목사 쫓아 다니는 못 것 들 목사 떠들고 다니나	FALSE
순수한 종교인 정치 참여 해서는 안된다  종교 제도 권 밖 이탈 해서는 안되고  오직 사랑 평화 믿음 순수하게 이끌어  나가야 된다	FALSE
미친거 아니냐  제대로 된 기독교인 이 라면 전광훈 이단 거 다 안다  이명박 안 찍으면 생명 책 지워 버린다  했고  하나님 까불면 죽어 했다  이런 말 아무 것 모르는 평신도 절대 할수 없는 말  이런 쓰레기 옹호 한다는 것  니 들 똑같은 쓰레기  니 들 똑같은 극우파 보수 꼴통	FALSE
교인 들 인정받게 할려면 이러면 안되는 일  아닌가 싶네요  우리 겪고 있는 감염병 아닌데  전세계 이 겪고있는 지구인 들 전염병  침착하게 대처 해서 신도 들 설득 못 할 망정  정부 국민 상대로 한번 해보겟단 거  믿음 중요시 하는 성도 들 생각 해서 그러면  안되는길 선동 내란죄 란 사실 명 심하 쇼	FALSE
너희 들 지금 정부 싸움 걸고 있는게 아니라 전 국민 들 상대로 전쟁 벌이려 하는것이다 앞뒤 모르고 그렇게 나대다 정말 진짜 국민 들 손 뒤진다 조심 하라 예수 쟁이 들	FALSE
미션스쿨 나와서 성경 다 읽었는데  그때 학교 목사 님 종교 믿는다면 타인 모범 되야 한다 했는데  기독교 계 자정작용 없나  기독교 계 정통 장로교 성결교 감리교 왜 입 닫고 있나  이상태 라면 그대 들 이단 무시 하던 그 이단 들 보다 나은것이 무엇  전광훈 그 줄 댄 목사 들 두렵나  픽박 두려웠다면 예수 인간 대신 해 속죄 했겠는가  아님 입다 있다 떡 고물 떨어지길 바라나  거짓 선지자 들 가득한데 유다 배신 하려 하는가  그렇다면 기독교 하지말고 전광훈 교 하고 그 우상 섬기라	FALSE
저 것 들 믿는 신은 사탄	FALSE
한기총 속 한 교회 말 만들어도 역겹고 구토 나온다 대한민국 부정 하는 테러 단체 징그럽다 이런 것 들 하나님 팔 부를 축적 하면서 이나라 공산주의 나라 하는 그 입 찢 어 버 리 고 싶다 진짜 하나 닝 이 잇다면 자기 팔아서 돈 챙기는 사이비 를 가만히 놔두겟나 더러운 인간 집단 들	FALSE
전광훈 구속 종교 탄압 개독 무리  의사 국시 거부 하는 학생 비호 하며 정부 공격 하는 의사 교수 들  뭐 다른	FALSE
선거법 위반 들어갔었고 나올 때 조건 부였고 조건 어겨서 다시 들어갔는데 뭐 잘 못 됐냐 종교 뭔 상관 목사 죄 져도 감옥 보내지말라는 거 저런 안하무인 저 팔 게 들 지옥 석 니 들꺼 같은데 종교 이란 자기 종교 똥물 튀기네 교회 다닐 일 절대 없네 긴가 민가 했는데 천국 지옥도 없는게 확실하네 기독교인 들 예수 믿으세요 ㅎ	FALSE
기자 또 라이 몇 명 우리 기독교 대표 하는것 처럼 왜곡 하지 마라 대부분 기독교인 들 이런 눔 들 잡아 지옥불 던지고 싶어 한다  목사 선지자 성인 아니다 그냥 안내 자 일 뿐 기독교인 들 이런 눔 싸잡아서 욕먹게 하지마라	FALSE
나도 엄밀하게 말 하면 기독교 신자 정확하게 얘기 하면 천주교 신자 입니다  이제 당신 들로 인해서 어디 가서 나 기독교 믿는다고 말 못 하겠다  왜 그러는줄 아  이미 하느님 까불면 나 죽어라고 했던 전광훈 그 발언 인해서 기독교 정신 사망 했으며 더 나아가서는 기독교 내란 선동 참여 반란 군 인식 되기 때문  더 나아가서는 네 놈 들 개념 없는 행동 인해서 이미 신뢰 없어졌습니다  그러니 천주교 인 눈 봐도 니 들 개독교 부르는 것 실제 개독교 짓 하는 돌아이 들 넘치잖아	FALSE
전광훈 풀어주면 국민 탄압  이 예수 예 자도 모른 가짜 개독  예수님 그리 가르치던  니 들 지금 국민 대부분 기독인 핍박하고  욕먹게 하고 있다  어찌 그리 어리석냐 그러고도 지도자  지도자 집어치우고 굴속 들어가서 무엇 잘 못 되었는지  반성 해라  어리석은 사두 개인 서 기관 바리새인 같은  것 들	FALSE
개신교 없어져야 할 이유 입니다  개신교 목사 들 돈 색 환장하고 세습 탈세 이 정도 사회 악 입니다	FALSE
존경 하는 전 목사 님 감옥 순 교하 소서  빤스 벗고	FALSE
교회 단체 집단  아침 욕 나오게 만드  인간 쓰레기  사회 악  영업 하려면 정당한 세금 내고  간판 걸어야지	FALSE
대한민국 종교 기독교 는 범죄 불법 사용 하는 만능 키다  종교 기독교 가 뭐 그리 대단한 권세 되는 양 망나니 짓 입 열면 종교 탄압 종교 자유 지껄이는 쓰레기 기독교인 들 설치는 세상 돼 있다  종교개혁 왜 필요한가에 대한 답 기독교인 들 말 있다  정부 국회의원 들 이 대 한 답 해야 한다  앞 선거 기독교인 낙선운동 벌어져야 한다	FALSE
기독교인 들  본연 목회 활동  안  왜 정치 적 행동 하나  성 경 말씀 이웃  사랑 하라  정치 판 기웃 거리  성경공부 열심히 하세요	FALSE
교인 한 사람 참 목자 찾고 싶다  예수님 백분 일이 닮은 목자 없을려나	FALSE
전 로마 네로 황제 야수 쟁이 들을 모조리 잡아다 불 넣고 원형경기장 사자 밥 구 경 거리 몰살 시켰지  네로 그때 벌써 야수 쟁이 들이 인류 재앙 될것을 알앗지 너희 들 자유 넘치는 대한민국 살아있 음 감사해라	FALSE
C 대한민국 아멘 장사꾼 들 넘 처 는거냐  장로교 개척 교 기독교 통일교 예수 분신 술 쓰는 건지 번 예수 번 예수 예수 몇번 예수 있는거냐  서로 서로 이단 말 하는 예수 쟁이들  대한민국 종교 자유 있다  하지만 종교 정치 영향 주면 않 댄다는 법 존제 한다  둘 중 하나 해  종교 정치 둘 중 택해	FALSE
제발 당신 말 한 대로 전광훈 는 순교 해라 그럼 국민 들 환영 한다 제발 스스로 순교 해라 입 나불대지	FALSE
대 한 예수교 장로회 장로 놈 들 문제 있구만 여기 소속 교회 명단 좀 밝혀 봐	FALSE
니 들 이 사람 새끼  짐승 새끼  두 눈 깔로 옳고 그 름 봤으면서  미친 소리 하냐  전씨 딱 가리냐  나이 아깝다	FALSE
코로나 전도 하는 먹 사 코로나 교회 인간 들 코로나 당 코로나 전도 하는 매국노 단체  참으로 암울한 대한 민국 재해 재해 민 들 신음 자영 엽자 들 쓰러져 생계 위태 데  이 들 도울 생각 안 또 매국 질하겠다고 참으로 암담하다	FALSE
세금 한 푼 안내 불로소득 하면서 국민 들 고통 절망 엄청난 피해 입히면서 어디서 예수 찾고 하느님 입 올리고 정신없이 일 잘 하고있는 정부 비난 일 삼고 있냐 돈 밝히는 탐욕 사이비 사기꾼 들	FALSE
지 나라 대통령 왜 미국 구속 하  정신 병자 들 맞네 ㅋㅋ	FALSE
전광훈 스스로 자신 선지자 했다면서요 신약 시대 선지자 어디 있어요 하물며 현대  전광훈 편 선 목사 들 정신 차리세요	FALSE
특히 복음주의 적 입장 성 서적 교리 생활화 실천 목표 강조 있다 교회 정치 관 해서는 장로 주의 체제 유지 하며 정교분리 주장 신앙 생활 성경 생활 규범 채택 신율 주의 적 생활 神律主義的生活 지표 삼는다 대 신 총회 뭐 하는 곳 찾아봄  대신 총회 정교 분리 라며 부끄럽지도 않나	FALSE
교 계 단체 하지마라  대 신 총회 하자  대신 니 들 미친 교회 들	FALSE
아이고 참 가관 미친것 들 트럼프 같은 대통령 됐어야 하냐 바이러스 막 퍼뜨려 나이 많은 사람 들 죽고 찌 끔한 나라 아주 죽 사발 만들어 미국 일본 귀속 되길 바라지 미친것 들 ㄸ ㄹ 이 들	FALSE
종교 탄압 넘어 종교 말살 해야 한다	FALSE
아유 목사 새끼 들 지 들이 뭐라도 된줄아네 사기꾼 양 아치 들 이참 기독교 탄압 해서 동네 즐비한 빨간 십자가 다 없애 버리자	FALSE
그러니까 교회 욕 얻어 처 먹는거다  아니 이제 욕 단계 넘어서서 끔찍히 혐오 스럽다  진짜 정신 병자 들	FALSE
기독교인 다 또 라이 만들고 안 믿는 사람 들 혐오 감 심어 하나님 영광 가리는 저 사탄 종 들 지옥불 떨어지게 하소	FALSE
종교 탄압  너희 들 말 하는 종교 진정 종교  이웃 사랑 하는 기독교 정신 무시 하는 놈 들 무슨 종교 탄압 하나	FALSE
육개 월 수료 목사 들 단체 나온 겨	FALSE
국난 종교 앞장서서 국민 보호 해야하나 국민 비수 꼿는 말 되냐고	FALSE
그만 좀 해 신도 들 볼 낯 없다	FALSE
바이러스 전염 시키는 정신 병자 들 사살 하는게 맞다 탄압 같은 잡 소리 ♩ ♪♩♬♪ 있네  너 정신 병자 들 하루속히 박멸 하는게	FALSE
결국 광화문 집회 운반 책 전광훈 줄 된  목사 들이였구나  어째 교회 상대 적 너무 많이 환자 들 나오고 다 어르신 들 이 더  나도 미션스쿨 나와 성경 다 봤어도 주님 믿으라 했지 목사 믿으라 안 했고  노아 의방 주 목사 아니라 신실한 노아 탔다  믿음 소망 사랑 중 제일 사랑 했다  정부 종교 탄압 하는게 아니라  너희 들 이웃 소 상공 인 너희 손자 손녀 국민 탄압 하는거다  나도 대지 제발 곱 미처  그리고 종교 팔지마라 성경 거짓 선지자 조심 하 했다  교인 분들 성 경 좀 읽고 참 목사 골라 믿으세요 제발 좀	FALSE
미친 개독교 놈 들 아직도 정신 못 차리냐	FALSE
놀고 자빠졌네 같슨파들 잔소리 집워 치워라 기독교인 들 원한다 저런 목사 필요없다 나라 혼란 빠트리 기독교 욕먹이고 욕심 많아서 재건축 들어가는대 그 교회 배 더 달라 하는 인간 죽 감옥 나오지 말 그게 바램 이상한 목사 들 다모 엿 네 저런 교회 들 저런 목사 들 성도 들 정치자금 대주 미친 통닭 당 정치자금 대주 태극기 부대 들 알바 비 대주 그런다	FALSE
ㅁㅊ 것 들 저 것 들 잡아 가둬라  특별히 순교 할 기회 주마	FALSE
요즘 교회 정치가 성직 제정일치 사회 회귀 여기 사우디 이란 대단한 대한민국 교회  선거법 이구 집시법 이구 그냥 목사 이름 앞 무력 화  법위 군림 하 교회	FALSE
예수 천국 목사 지옥 맞네	FALSE
대 신 총회  교 계 대표 인척  하네 ㅡ 이런 걸 두 고도  말 하 없는  교회 실망했다	FALSE
너희 들 쓰레기 거 이제 전 국민 다 안다  너 들 좋아하는 하느님 나라 빨리 모두 가버려라  제 발	FALSE
전광훈 사리 분별 못 하나 했는데 지천 깔렸네 후세 들 미안하지도 않나 그런 판별 력 이면 이제 물러나서 집 쉬세요 그게 올바른 처신 입니다	FALSE
대한 예수교 장로회 목자 들 모임 아님 사탄 무리 종교인 들 스스로 잘못 해놓고 그 잘못 국가 타령 하 건가 정말 예수님 욕 보이 하나님 혼내는 자가 목자 맞는가 그 무리 들 당신 들 가짜 목자 들 때문 개신교 신자 들 많이 줄었다 대형 교회 살겠지만 작은 교회 목자 들 당신 들 때문 목자 생활고 격는데 당신 들 배 들 기고 예수님 팔아서 잘살겠지 더 이상 예수님 팔지 진실한 목자 돌아가라	FALSE
교회 다니기 싫다 헌금 내기 싫고 저런 인간 들 밥 먹여줄려고 헌금 내는거 아닌데 종교 옮길까 고민 중	FALSE
하나님 없다는 것 더욱 분명해지는 빼박 증거	FALSE
전광훈 종교인 극우 꼴통 정치 쓰레기	FALSE
대 한 예수교 장로회 목사 이 써 그 을노옴 들 마퀴 전광훈 혹세 무민 되었구나 고로 대 한 예수교 장로회 교회 다니는 교인 여러분 들 빨리 교회 떠나 다른 교단 교회 가세 이제 그 들 적그리스도 파가 되었어요	FALSE
나도 교인 요즘 고 회 나기기 싫다  교 계 지도자 들 왜 입 꾹 닫고 있나  한국 교회 요즘 위기 빠진 적 있던가  자기 앞 가름하기에 급 급해 교 계 산 는지 바다로 가는지 관심 없단 말  그래놓고 이 사태 끝나면 교회 나오세요 하고  뻔뻔스럽게 전도 하겠지  교회 사랑 진실 사라진지 오래 다  있다면 그 들 잔치 뿐 허례 가식 그 자리  차지 있을 뿐  누워서 침밷 기인 줄 안다  곪은곳 도려내지 아니하면 머 않아 한국 교회 목사 들 남을것이다	FALSE
어이 없어서 말 안 나오네	FALSE
빤스먹사 똘마니들 니 들 한 짓 생각 해보라 실내 실외 한번 걸리면 뇌 심장 온몸 장기 들 모두 상한 다 아무 생각 없는 어른 들 때문 학생 들 학교 못 가고 미안하지도 않은가 마스크 안 쓰고 돌아다니는 사람 들 대중교통 이용 하면서도 마스크 쓰라고 하면 오히려 큰소리 치는 사람 들 동선 숨기 허위 진술 하는 사람 들 내 국 인 외국인 본인 치료 비 뿐 아니라 확 진자 때문 피해 입은 사람 들 모든 치료 비 생활 비등 구상권 청구 해야 한다 특히 가족 친지 친구 지인 들 평생 씻을수 없는 상처 주게 될것이다	FALSE
종교 탄압  범죄자 수감 시키는게 법치국가 당연한 일이	FALSE
종교 탄압  국민 들 생명 위협 범죄 단체 아니냐  종교 자유 위  국민 국가 있다  어디서 반국가단체 언사 행동 하느냐   종교 를 빙자 범죄 단체 정치 나서면  그 조직 강제 해산 시키고 수뇌부 모조리 구속 시켜야 한다	FALSE
적당히 하시죠 진짜 전 국민 한 데 인민재판 받기 전 교 계 왜 평판 이리 된 건지 잘 생각 해보세요 사람 라면 알 테 모른다면 종교 핑계 피해 주는 단체 겁니다	FALSE
교 계 단체 당 연 기독교 계 뿐 다른 종교 단체 전씨 그러지도 않고 기독교 그러지 않아 다른 종교 들 철 성인 모습 이면 전씨 종교 정신 놓은 망 같음	FALSE
광훈이 말 한 달이 빨리 왔으면	FALSE
전부 입다 물어 예수님 하나님 너희 들 보고 계신다  너희 안 죽을거 같지  죽기전에 회개 하면 될 거 같지  정신 차려 난 한 사람 구원 하려고 칼 갈이 봉사 하는데 지금 코로나 때문 칼 갈이 못 해 마음 아픈데 사람 들 오면 전부 너희 들 욕 해대 내 죽 노릇 그렇다고 같이 욕 할 수도 없고  쫌 가만있어 주면 도움 크게 되겠는데  그 입 들 다 물	FALSE
국가 허락 만하 저 껏 들 다 쓸어 버릴텐데	FALSE
도대체 이해 안 돕니다  그 예수님 제자 맞습니까  기독교 왜 사회 적 지배 체제 만 갈구하는 것 일까 요	FALSE
우리나라 성직자 란 이름 뒤 숨은 모자라고 미친 먹 사들이 많은지 모르겠습니다  누가 답좀 가르쳐주십시오	FALSE
교 계  저 인간 목사 아닌데 뭐  박탈 당했구만	FALSE
뭔 개 소린  사법 정의 살아있 음 범죄자 보석 허가 조건 위반 따라 구 속 한 게 어찌 인권 탄압 종교 탄압 전체주의 공안 정치 이자 구속 하지 않는것이 바로 헌법 훼손 이 사법 정의 개판 되는것이다  하나님 팔 장사 하는 비열한 사탄 아바타 들 스스로 지껄이는 내용 뜻 모르고 짖어 대는구나  전광훈 비롯 네 놈 들 사회 악 이 사탄 자식 들  언제 하나님 자신 정치 목적 이용 하는것 들이 목사 였는가  그냥 ♩ ♪♩♬♪ 일 뿐	FALSE
광훈이 나라 꼴통 들 골라내는데 지대 공 세우는구나 훈장 줘야겠다	FALSE
목샤 없는세 샹 살 해 쥬씨옵쇼셔	FALSE
나도 하나님 믿고 살 정말 이 물건 들 인간 이기 포기 좀벌레 들 같다 이 것 들 사람	FALSE
성직자  누가	TRUE
미친것 들	FALSE
하아 저 무지한 사람 들 어째 하나	FALSE
전광훈 이 목사 아니니 종교 탄압 같은 소리 마시오 그냥 간첩 요 국민 들 분열 시키는	FALSE
교 계 하는것 들은 누구  전광훈 용돈 받던 그 목사 들  기독교 정말로 혐오 스럽다 ㅆ	FALSE
너희 들 사회 암 덩어리 바이러스	FALSE
바이러스 먼저  종교 집회 먼저  머리 안 돌아가나 벼  국민 건강 먼저	FALSE
전광훈 버리고 기독교 살 건지  아니면같이 죽든지네  종교 정치 하면  사랑 없고  투쟁 만남	FALSE
전광훈 한 패거리 들 모였다   다 잡아들여라  저 것 들 목 사란다	FALSE
이만 희 전광훈 난 이렇게 된다고 봄  신천지 교인 코로나 감염 숨겨서 난리 났었고  전광훈 이 집회 때 전국 코로나 감염 퍼트렸  둘 뭐 달라  둘다 쓰레기	FALSE
종교 란 옷 입고 사람 흉내내 것 들 너무 많네요	FALSE
목사 님 들은 하느님 시켜서 거짓말 하다고 하 데	FALSE
어느 교단 어느 목사 들 정확하게 밝혀라 아주 짓 밟아 버리게 저런 교회 다니는 사람 들 불쌍타	FALSE
요즘 교회 관계자 들 실망 큽니다 머 초록 동색 이라지만 상과 벌은 투명해야져 특히 종교 계 여	FALSE
무인도 가서 살 죽든 해  예 수재 이 들 졸 짱 난다	FALSE
국민 생명 권 갖고 뭐 하는 짓  교 때문 소상 공인 들 더 힘들어진다  죽어서 천당 가든 말 제발 한 곳 있어라	FALSE
다른건 됐고 이번 기히에 종교 단체 과세 하라	FALSE
종교 탄압  니 들 코로나 걸려 고생 안해 그런 말 하는것 같구나   의료 공무원 들 의사 간호사 들 힘든것을 모르나  성직자 교인 말 쓰지마라  니 들 성경 나오는 악마 들	FALSE
박정희 때 였으면 섬 끌려가서  정신 교육 확실히 받고  쥐 새도 모르게 죽었을거고  전두환 때 였으면 그 자리  탱크 장갑차 군인 들 창 검 총 죽어 없어졌을거고  두테르테 대통령 이었으면  즉시 총살 당했을거고  니 들 최상 좋은 세상  유신 시절 조용히 살던 것 들  국민 들 투표 뽑은 대통령  한낱 목사 따위 전국 적 알바 소집 해서  국민 들 코로나 바이러스 확산 시켜놓고  국가 재정 국민 가계 살림 파탄 내놓고  종교 자유 종교 탄압 떠들 수 있는	FALSE
종교 탄압 미친거 아님 그게 종교 탄압 이 파리 새다 사이비 먹 사들이 저딴 소 릴 하 제발 닥치고 조용히 집 기도 해라	FALSE
기독교 민낮 이번 드러났지 ㅋㅋ	FALSE
국민 위험 빠지게 하는 개신교 목사 믿지말고 하나님 믿으라고 네 참	FALSE
예수 팔 먹 고  개판 치는 사탄 무리 들	FALSE
합법 적 정부  전복 하자는이단 먹사  무슨 종교 자 유란 말	FALSE
보석 풀려 났을 때 불법 적 집회 주도 하지 않는다는 약속 하고 풀려 났는데 다시 불법 적 집회 주도 했고 그 집회 수백 명 감염 됐고 본인 집회 앞두고 감염 되었죠 그로 인해 코로나 재 유행 되었습니다 그로 인 사회 적 비용 천 정부 지로 치솟았고 현재 방역 단계 높여서 자영 업자 들 대부분 폐업 할 위기 처 해있습니다 예수님 가장 큰 가르침 너 이웃 네 몸 같이 사랑 하라 아닙니까 이웃 피해 줬음에도 그걸 간과 그저 같은 목사 로서 감싸 안는다고 하면 더 이상 교회 미래 없을것 같습니다 지금 자중 할 때 입니다	FALSE
전광훈 목사 난 하느님  개신교 기독교 신천지 기독교	FALSE
개신교 답 다 그러고도 수 앞 안 부끄럽소	FALSE
종교 자유 란 종교 선택 자유 종교 방패 국민 들 위험 빠뜨리고 정치 적 행동 하 뜻 아니다	FALSE
보석 금 내고 구속 면 인간 그리 펄펄 힘 넘쳐 나대는데 보석사 유가 사라지면 당연히 구속	FALSE
종교 탈 쓴 정치인 되고 싶은 전씨  얼른 하나님 곁 가라  그게 마지막 사죄 길이	FALSE
역시 교회 지 밥그릇 지신 지 교회 지키면 되니깐  입다 물 ㅠ 조용 ㅇ 히 눈치 보는구나 무슨 그 따구가 종교 지껄이다니	FALSE
한국판 종교개혁 필요한 시점	FALSE
목사 위법 해도 처벌 하지 말 이야기  전광훈 비상 식 적 몰이 성적 행동 인하여 국민 들 얼마나 큰 피해 입고 있는가  위법 행위 모두 처벌 할 수 없지만 전광훈 지금 한 행위 들 국민 들 정서 반하는 행동 지속 있으며 그 행위 인하여 국가 적 손실 발생 있으며 방역 동참 있는 대다수 국민 들 삶 힘들게 하고 있다 그럼에도 불구 국가 정당하고 합법 적 조치 비난 대 정부 투쟁 주장 하는 사람 들 대한민국 국민 아니고 종교 지도자 더 더욱 아니다	FALSE
교 계 대표 하지 않는것 들이 국가 사회 망치려 하고있다	FALSE
탄압 좋아하고 있네  전광훈 그 들 때문 얼마나 국민 고통 받고 있는지 생각 해 보세요 대한민국 경제 손실 생각 하다면 그런 탄압 할수 있나 가슴 손 놓고 생각 해보세요  당신 들 독실한 기독교 신자 하면 정부 시책 반대 할수 있는지 분석 할수 있는 좋은 기회 입니다  여러분 들 국민 모두 똑같은 국민 입니다  앞 코 레나 간 염병 적극 협조 할수 있는 기독교인 되길 바람니다	FALSE
개신교 개 목사 들 보면 종교 이용 해 자기 이익 눈 먼자 들 모임 퇘퇘	FALSE
선 긋기 하더니  대교 계 종교 탄 합 이란다  도대체 정신 들 있는 사람 들  민주주의 정말 싫어지고 있다  전두환 처럼 탱크 밀고 오고 전투경찰 곤봉 얻어 맞아야 하는 나라  국민 생명 안전 위반 하는자 들은 구분 하지 무조건 공권력 다스려야 한다	FALSE
저 기 대신 총회 하는거 몇 교회 안되는 소규모 집단 전광훈 이 원해있던 교단 짤려 주고 들어간데 입니다	FALSE
니 들 국민 탄압 하고있다	FALSE
개독 헌금 수입 vs 소 상공 인 생계  개독 목사 자기 목구멍 더 중요하지	FALSE
교 계 단체 어디 말 하시는지 내 알기 자기 들 단체 인걸 아는데 대부분 교 계 전광훈 목사 인정 하지 않습니다	FALSE
매 안 맞아서 모르지  맞아 본 넘 들은 손 들어도  찔끔 하지  탄압 당할 일 안 하면 되는데  지 들만 사는 세상 만드는 놈  어찌 하느님 팔고 니나	FALSE
재네 들 때문 소상 공인 다 죽어가는데	FALSE
아무 데 종교 탄압 갖다 붙이 말라 당신 들 하나님 바라보고 예수 삶 따르며 성경 말씀 실천 하였는가  정치 논 할 때 부터 그대 들 기독교 벗어난 사람 들 하나님 뜻 위배 했으며 예수 욕 되게 했다	FALSE
예 장 그럴 줄 알았다  니 네 들 신앙 인	FALSE
이 땅 개신교 사회 악 제발 우리나라 사라져라 이 악마 들	FALSE
그러니 예수 쟁이 소리 듣지  그러고도 한 가정 가장 할수있냐  니 들	FALSE
대 신 교단 축출 되었던 전광훈 왜 감싸는가  고 신 이 단 가능성 언급 하는데 대 신 교단 손절 한 게 아닌가 보다  전광훈 감싸다가 교단 위태 울 수 있다	FALSE
코로나 좀비 들 급증 하더니 이제 모두 뭉치는구나  개신교 코로나 좀비 군락 지다	FALSE
아 휴 증말 당신 들 제대로 된 목사 들 맞나요 뭘 종교 탄압 하냐구 니 들 온 국민 코로나 퍼뜨려 불안하게 살 하면서 이 시국 봐라 이 종교 탄압 이 정신 나간 목사 갖지 않은 목사 들	FALSE
저 교단 기독교 교단 보면  안 돼요  전광훈 궤 같이 하는 사적 집단 입니다	FALSE
끼리끼리 노는군  교인 이면 하나 둘인지만 찾고  정치 하는것 들은 국민 위 일만 하면 되는데  왜 그리 하나 찾는것 들은 오지랖 떠는지  교회 다 없어져야 한다  하나님 어딨어 있어	FALSE
뭐 하면 탄압  보석 허가 어겨서 재 구속 된 걸  종교 연결 시키네  언제 종교 정치 관여 하게 됐냐  교황 대통령 허락 받으러 다니냐  지금 어떤시 댄데	FALSE
돈 환장한 위	FALSE
야 개 짖는 소리 좀 안나 해	FALSE
교회 아니고 일부 사이비 단체  하나님 의 우십니다  말세 예수 칭하 자가 여기 저기  나올거라고 하셨어요	FALSE
성경 전광훈 한 말 나와 있나요 하나님 까불지마 나 혼나 나 선지자 나 하나님 직통 한다  이 것 해결 하시고 종교 탄압 말 하시죠  아님 이단 탄압 말 바꾸시던가 동문 그렇게 감싸는 것 아닌 듯 합니다	TRUE
개신교 완전 썩은 쓰레기 집단 되어 버렸네 ᆢ 이 젠 세상 사람 들 교회 칭 하지마라 ᆢ 조롱 비난 소리 듣고있으니 ᆢ	FALSE
정권 한 게 아니라 법원 판결  니 네 집권 할 땐 양승태 권력 시키는대로 했지만 민주 정부 윤석열 최고 존엄 군림 하는것만 봐도 모르겠냐 민주 정권 권 분립 고수 있자낰 ㅋㅋㅋ	FALSE
성경책 어디 목사 님 정치 하 말씀 없습니다  지금 대한민국 일부 목사 님 들은 하나님 목회 하는 것 아니라 본인 정치 활동 하 는걸 보입니다  제발 정치 하고자 하면 목회자 아닌 정치인 직업 바꾸고 합니다  더 이상 하나님 영광 가리는 목회자 뒤 숨은 정치인 없었으면 좋겠습니다	FALSE
대신 측 이제 당신 들 미쳤구나 종교 탄압 무엇 알고나 뗘드 거	FALSE
대 신 총회 또 어떤 교단 이 시국 정말 정신 없는 집단 제발 자중 해라 그게 하나님 뜻 제발	FALSE
사랑 제 일 교화 사택 나오고 있다 사진  근데 사랑 제 일 교회 사택 왜 전광훈 씨 와이프 명의 되어 있는지 그것 알 싶다 방송 분 보면 전광훈 씨 하는말 장로 님 들이 사택 구입 해야 하는데 장로 들 명의 할수 없어서 목사 님 배우자 명의 했다고 하면서 어색한 웃음 본인 말 하면서 머쓱했을까 이 거 횡령 아닌가 싶은  그런 돈 문제 둘째 사랑 제 일 교회 합숙 집회 광화문 집회 발 코로나 확진 대한 국민 피해 대해 사죄 해야하는거 어닌 하나님 네 이웃 사랑 하라 했는데	FALSE
전광훈 행위 종교 적인것이 있더냐  종교 적인것이 있다면 하나님 모독 국민 들 반기독교 적 생각 하게 한 점 사탄 이런 사탄 없을것이다  당신 들 또한 전광훈 별다를것 없는 하나님 욕 보이는 사 탄일 뿐	FALSE
코로나 전파 자 종교 탄압 교회 코로나 퍼 뜨 리  사람 죽게 만든게 목사 맛 그러데 종교 탄압  목사 들 왜 인생 그 럲 게살 베풀고 사랑 살아요 제발	FALSE
종교 탄압 좋아하네 대한민국 국민 아니면 이나라 떠나라  종교인 들 법도 없고 마음대로 하여도 된다고 하던가  지금 국민 들 코로나 때문 같혀 사는 세상 뭐 하자는것인지	FALSE
예수 팔 지 배 채우는 자 들	FALSE
사이비 개 먹 사를 종교 탄압 이	FALSE
재수감 누가 명령 했는데 법원 잖아 니 들 논리 라면 법원 종교 탄압 하는거네 억울하면 대법원 앞 가서 데모 해	FALSE
일부 기독교 헌법 위 존재 할 말 없음 대한민국 국민 이길 거부 하는 자는 추방 해야 한다	FALSE
교회 없애든지 전광훈 따라 구치 소가 국민 들 용서 안해	FALSE
목사 목사 다 워 목사  국민 욕 있다 이 목사 들아  경제 살아날 기미 보였는데 자영 업자 들 전부 파산 지경  제발 경제 살아나도록 기도 해주고  좋은 일 앞장서주라	FALSE
소 신 껏 잘 한다 ㅡㅡ  문 정권 더러운 정권  조국 윤미향 추미애 임종석 이인영  전부 공산주의 사상 북한 보낼 놈 들	TRUE
목회자 인간 들 부끄러운줄을 알아라  하나님 까불면 죽는다고 협박 하는 미치광이 편 들 지지 하는 인간 들 어찌 입 주님 소리 한다는 게 우습다  개독 목사 들 이제 그만 입닥 집 요단강 건널 때 혼자 성경 많이 보셔	FALSE
한 국내 개신교 개 교단 들 중 하나 전광훈 꼬붕격임 저번 총선 때 기독 자유통일 당 지 지 선언 보수 정치 교단 임	FALSE
미친것 들 종교 이용 하 정부 대항  국가원수 모독 하 것 들 전광훈 장난 치는거  못 보니 심심하냐 ㅉ ㅉ ㅉ ㅉ	FALSE
그래  전광훈 원로 목사 들 용돈 쥐어 줬다더니  이 때 위 함이었구나  빨리 가라  하나님 너희 죄 심판 하실것이다	FALSE
전광훈 목사  우리 집 화장실 두루 마리 휴지 팔만대장경	FALSE
그냥 다 벼락 맞고 ♬♪ᆞ  십자가 좀비 ♪ 들	FALSE
스스로  우리  개독 쇡 기 들 입니다 자인 하네	FALSE
위법 해서 재 구속 하는것이 종교 탄압 하니  한 심 스럽다 올바른 교육 받지 못 한자 들  행태 그러니까 맹신 광신자 하지	FALSE
전광훈 똑같은 놈 들 실 처분 해 버려라	FALSE
종교 활동 안 하는 것 들 무슨 종교 탄압 타령 니 들 정치 활동 했지 종교 활동 한 게 있어야 종교 탄압	FALSE
내 요즘 아이 들 이 극혐 이란 단어 쓰는거 별로 안좋다고 생각 했는데 요즘 교인 들보 극혐 이란 단어 잘 어울 리 것 같다는 생각 든다 종교 탄압	FALSE
종교 탄압  헛소리 정도 껏 해  그러니 개독 교란 말 듣지	FALSE
가증 스럽다  이런 자는 신성모독 그 자리 죽어도 시원찮을 텐데 옹호 하는 니 들 죄 없다 하지 않을 것	FALSE
씌레기 인증 하시네   먼 짓 들 하시나	FALSE
탄압 어이 상실 재 들 머리 속 뭐 들었을까 나라 민주화 되는것도 문제 되는듯 ᆢ 나라 무너질까 걱정 된다	FALSE
예수 하나님 교회 바로 이단 입니다  예수 선지자 즉 시 람 일 뿐 이	FALSE
개신교 또 이렇게 국민 들 실망 시키는구나	FALSE
개신교 교회 아직 정신 들 못 차렸다 진짜 민폐 덩어리	FALSE
사이비 들 닥쳐라	FALSE
니 들 바이러스 ᆞ  종교 탄압 아무 데 갖다 붙이냐	FALSE
종교 정치 손때	FALSE
예수 쟁이 들 때문 전 국민 힘든거 안보  예수 쟁이 들 한 테 진짜 욕 안 나오네	FALSE
전광훈 외 몇몇 이상한줄 알았지 기독교 자체 썩을 대로 썩었네  이렇게 자정 능력 없고 현실 파악 안되는 자 들 종교 지도자 울 나라 기독교 희망이 없다	FALSE
나도 크리스찬 이건 종교 탄압 아니다 불순 물 재거 제발 사랑 하는 주님 자녀 들 똑바로 보세요 당신 들 이기심 교회 무너져요 요즘 저 들 보면 일제 시대 목사 들 천왕 숭배 떠올라 진짜 하나님 이름 아무 대 팔지마라	FALSE
보석 조건 어겼으니 당연한거 아님  아무리 팔 안 굽는 다쳐도 제발 상식 적 생각 좀 하자	FALSE
이제 서야  진짜 가짜 들어나네요  이 들 나라 오염 시키러 하는구나  우리 용서 해서는 안 됩니다  기독교 탈 쓰고 야만인 짓 하는 악종 들  아오 내 다 빡치네  전광훈 철창 오래 동안 격리 시켜야 평등한 법	FALSE
전광 후니 목사 내 예수  ♬♩ ㄱㄷㅇ	FALSE
만고 쓰잘 데 없는게 개신교	FALSE
기독교 ᆢ 이제 진짜 빠이빠	FALSE
이 무슨 종교 탄 입 보석 조건 어겼으니 당연히 보석 취소 거지 코로나 겁나 죽겠다 방역 방해 하는 놈 들 다 잡아다 가뒀으면 좋겠다	FALSE
인간 말종 쓰레기 들  요 넘 들은 분리수거 해서 소각 해야 합니다  코로나 바이러스 같은 사회 병균 들 저런 쓰레기 들 목사  참 목사 고시 시험 출제 하 인간 들  누구  이런 인간 들어게 목사 자격증 주었을까  학  퉤	FALSE
전광 후니 목사 난 하나님	FALSE
진짜 다 쏴 죽이고싶다	FALSE
너 네 모시는게 신인 돈 확실히 하라	FALSE
정말 답 없는 집단  이미 정치 색 띈거 자체 문제 있고 객관 적 판단 못 하는것도 문제 모든 상황 광화문 집회 증거 다 들어나고 있는 마당 싸고 돌걸 돌아라  계속 그러다가 모든 개신교 대한 국민 들 불신 커진다 하나님 나 까불면 죽는다 했던  전광훈 편 들다니 진정 기독교인 맞나 하는 생각 든다 정신 똑바로 차려	FALSE
전광훈 때문 이번 대한민국 개신교 교회 들 목숨 왔다 갔다 하는 상황 됐다  정말로 헌신 희생 예수 대속 정신 실천 교회 들 살아남을 것  열심히 돈 벌이 몰두한 교회 들 공중 분해 될 것 예상 된다  부자 세습 해가면서 재산상속 하면서 교회 신도 들 공금 횡령 목회자 들 확실하게  처벌 해야 한다  그리고 몰수 해서 사회 환원 해야 한다	FALSE
종교 탄압 라이 대가리 돈 들어있는 먹사 새끼 들 종교 자유 니 네 들 그 종교 믿는다는 이유 탄압 받지 않을 권리 있다는 거지 뭔 ♬♪ 해도 된다는 뜻 아니야 정말 무식한 것 들  하긴 지 덜 끼리 안수 주고 목사 하는 수준 뭘 기대하겠나	FALSE
이번 기회 국민 들 종교 계 많이 이탈 하시기 바랍니다  교회 곳 들 대부분 이렇게 막가는 인생 들 접  있다는 생각 많이 들고 앞 교회 말 만들어도 눈  보이 기만 해도 침 뱉어 버릴거다	FALSE
저런 ㅁ ㅊ 놈 살려 두는것조차 이해 할수가 없다  진즉 때려 ㅈ 였어야 할 놈 저런 걸 믿고 따르는 한심한  인간 들 인간 이겠는가  쓰레기 인생 들	FALSE
뻔 뻔한것 들이 악마 변해서  종교 국가 국민 탄압 하  세금 안내면 별 주장 다  국민 돈 살려내니 더 날뛰네  이번 격리 시키고 치료 하지마라  죽게 놔두어라	FALSE
대신 총회 교 계 어떤 위치 있는 곳 일까  기자 라면 그 단체 어떤 곳 인지도 알아보고 써야 하는거 아닌가  교회 이름 붙이 다 교회  이상한 사이비 집단  정통 교회 키워주고 있는게  구김 당 기레기 들인줄이나 알아라	FALSE
대신 총회 명단 반 ㄱ 혀 떳떳하게	FALSE
교 계 단체  돈 미친 앵벌이 거지 들 무슨 교 계  하나님 그리 가르쳤어 저 빤스 목사 놈 주딩박 돌 치고싶어 ♪♪♩♬♪♪	FALSE
이 종교 탄압  진정 미친거아니야  완전 돌아 버렸구나	FALSE
아가리 싸 물어 ♪♩♩♪♪♬ 들아 느그 들보 개 빡쳐	FALSE
대신 총회  전광훈 이  만든 단체 메  이 단 이만 이단 단체  아닌가	FALSE
영 세 학원 정지 주 전광훈 손해배상 전자소송 낼테니 자 영업 뿐 아니라 사회 모든 시스템 동결  사회 악 본인 다 안다 월세 도 못내	FALSE
이제 교회 망했다	FALSE
저 개독 들 전광훈 졸개 들이거나 뉴라이트 회원 일 것  썪 어 빠진 논리 스스로 조롱 하는 수 구 꼴통 들	FALSE
정치 정치인 들 맡기고 신앙 생활 열심히 하세요  예수님 정치 기웃 거리 시키던가요 이럴시 간있으면 나라 위해 금식 기도 하세요 제발  무엇 바라고 들 이러는지 속 내 궁금하네 나라 세금 안내 집단 들	FALSE
니 들 생각 하기에 텔레반 아이 에스 총 안 들었지 뭔 차이 있다 생각 하니 도를 넘어 반군 수준 아니야	FALSE
흥선대원군 선택 옳았던거야  예수 믿으면 천 국가 안 믿으면 지옥 간다 교리 나와있자 너  저 놈 들 오로지 지 들 뿐  세금 안내 목사 새끼 들 코로나 비용 한 푼 내 봤냐	FALSE
한국 교회 끝났다	FALSE
ㄸ 라이  ㅗ  집단 아닌가  정신차려라	FALSE
숨 턱 막힌다	FALSE
생명 책 교인 이름 지 맘대로 쓰고 지우고하는 놈 편 드는 저 것 들 목사  교단 똦겨나 목사 직 박탈 뛰 쳐나가 새 교단 의 교주 한 게 전광훈 하는데 저 것 들 목사 주제 이단 감싸네	FALSE
쓰레기 들	FALSE
너 눈 전광훈 이 목사 보이  이 정신 나간 인간	FALSE
야 나라 망치는데 재수감 문제  사형 시켜라	FALSE
사이비 사기꾼 목사 두둔 하는 교 계 과연 어떤 곳 들 진짜 교 계 전광훈 안엮일려 더 거리 두기 할텐데 말	FALSE
개독 법위 있냐  보석 조건 어겼으면 다시 구속 법  잘 모르면 가만 좀 있어라	FALSE
역사 적 나라 위급할 때 승려 들 들고 일어 났다 기독교 오직 예수 지키기 위해 순교 했을 뿐	FALSE
강력하게 처벌 징벌 적 손해배상 시켜라 천국 팔 먹는 사이비 종교인 들 정치 모리 배 들 대한민국 말아먹는다 그 들 재산 몰수 국외 추방 하 지 들이 팔 먹고 좋아하는 천국 빨리 가버리지 왜 인간 세상 힘들게 하는지   지옥 가면 사이비 종교인 들 정치 모리 배 들 득실 득실하여 지옥 만원 사례 나오겠다	FALSE
목사 아니다 교 계 무슨 교 계 국민 아니면서 국민 힘 놈 들 똑같은 패거리 들	FALSE
미치광이 예수 쟁이 들 살인마 악귀 들 니 들 싹 다 죽어 마땅한 살인마 들	FALSE
저 교회 목사 님 들 장로 님 들 다 지옥 가실 거  빨리 예수 믿고 회계 하세요  이대 로라 지옥 행 퍼센트 임	FALSE
또 욕 쳐 먹을 짓 한다 이 집단 명단 전국 공개 해야 한다 사람 들 피하	FALSE
아주 찍 소리 못 하 밝아 버려 야한다  진짜 꼴도 보기 싫다 왜 저러는 건지  저 사진 꼴도고기 싫다 죄인 참 당당하구나	FALSE
이 것 들 겉 쇼 하지 절대 정신 못 차려	FALSE
아무리 돈 좋지만 저런 분 경호 변호 하시는 분들 대한민국 인 자신 하실 수 있습니까 보기 정당한 행동 같으신 가요	FALSE
대 한 장로회 산 가고있네  대단하다 목사 사람 들 정부 싸우고 탄 입 뭐 명분 같지 않은 명분 붙여서 뭐 하는 짓  성경 읽고 울면 기도 해야 할 교 계 미쳤구나  종교 탄압 좋아하시네 당신 들이 이렇게 다 만든 자작 극 잖아 제대로 성경 모르고 그 자리 앉아서 걱정 근심 없이 먹고살 만하 시간 남아도 분데  차라리 이나라 떠나라 꼴도 보기 싫다  무슨 ㅇ 부귀 영화 누리겠다고 지네 들 땜 코로나 고통 받는 대한민국 국민 들 힘들어서 죽기 직전  니 네 들 돈 그렇게 많 나본 데 힘든 국민 들 풀어라  고 소 비용 변호사 수임료 날리지말고	FALSE
무인도 싹 다 가두고 달 간 식량 지 원 해조  지 들 끼리 주님 찾다가  주님 곁 가게  이참 개독교 청소 좀 하자  인구 많은데 보내자  아마 좋아 디질꺼다  천국 갈건데 머 문제 ㅋㅋ	FALSE
언제 이 단 교회 선 긋기 하더니 이 젠 도 돌아서서 악마 같은 전광훈 보호 나셨네  진짜 개신교 답 없는 것 같다	FALSE
최소한 양심 없는 무리 들  개신교 이단 걸러 내는 노력 하는것이 그나마  사회 진 빚 갚는 것 될것	FALSE
종교 탄압 하는 인간 들 모두 사이비 거짓 신앙	FALSE
진짜 탄압 해 버리고 싶다 이 새끼 들  작작 좀 해	FALSE
그래서 너희 들 사회 악 욕먹는 거야  평생 절대 바뀌지 않는한	FALSE
종교 탄압 같은 소리 자빠졌네 ㅁㅊ	FALSE
니 들 대한민국 탄압 하지 마라	FALSE
저 들 순교 할 기회 줘라 싹 다 모아다가 소 각 처리 하자	FALSE
종교 더 이상 성역 되어서는 안 됩니다  우선 세금 형평성 있게 부과 하세요 이참 아주 좋은 기회 이지	FALSE
돌 팔이 목사 놈 들 니 들 무슨 종교인 양 아치 사기꾼 들 혹세 무민 하 나라 망치는 암 덩어리 들 기독교 말아먹는 니놈 들 목사 탈 쓴 적그리스도 사탄 할렐루야 주 저 들 지옥뷸 던져주소서	FALSE
진짜 계엄령 내려서 백골단 방망이 대구 리가 터져 봐야 알듯	FALSE
햐 이 인간 들 정말로 한국 개신교 조종 울리는구만  참 덧 없는 개 소리 들  크리스찬 참 자괴 감 듭니다 목사 하나님 교회 위 일체 믿고  반공 반 이슬람 반 동성애 타자 악마 화하는 개신교 종말 보이	FALSE
여보세요  목사 님 들  저 교회 째 주일 딱 두 번 예배 하지 못 했습니다  저  정말 지금 이런 작태 교회 욕 하는 대부분 국민 들 목소리 같이 동조 하지 않을수 없네요  더 이상 교회 이 사회 말 할수 없는 상황 놓여 있는게 보이지 않나요  한번 더 무릎 끓고 주님 사회 앞 진정 회개 하는 모습 보여줍시다	FALSE
진짜 종교 탄압 당하고싶냐  국민 들 지금 얼마나 성질 죽 참고있는데  조금 더 나가면 전국 교회 전부 불 질러 버릴지도 모른다  적당히 해라잉	FALSE
하나님 까불지마 했던 놈 목사  그걸 추종 하는 놈 들 목사 아니네 미친것 들 하나님 두려워 하지 않는것 들 무섭지 않니	FALSE
대신 총회  듣보잡 대 한신대 동문 들 보네  댁 들 개신교 대표 한다고 생각 하나요  스스로 어이없죠  전광훈 동문 부끄럽게 생각 해야지 원	FALSE
저 래서 요새 TV 광고 ♪♩ 재단 갑자기 대학 광고 ♩♪ 총회 그리고 개별 적 조직 포커스 맞추던데 이제 이해 가네 다 필요 없고 천주교 신부 님 개별 사업자 처럼 하시는게 아니니 천주교 신부 님 제외 나머지 종교 세무 관련 실태 파악 위 조사 하자 안되겠다 세무조사 고고	FALSE
예수 세번 부인 베드로 지금 한국 교회 바로 하나님 부정 스스로 우상화 되어 가고 있다  기득권 결탁 되어 각종 권력 취해 있는 모습 바리새인 다를게 무엇  왜 한국 교회 다 들 대 헝 화 목 메는가 개교 회의 진정한 의미 무엇  풀 뿌리 신앙 아니겠는가 국민 들 속 사랑 희생 실천 하는 예수님 몸소 보여주시고 일 깨워 주신 우리 진리 다 어디 갔단 말  외식 하는 자라며 꾸짖었던 예수님 목회자 릍 바로 쳐다 볼 자격 있는가  한국 교회 많은 목휘 자 들이 바로 외식 하는 자인듯 하다	FALSE
그래 백 번 양보 해서 물어볼께  그래서 전광훈 이 잘 하고 있다는 말  왜 가장 먼저 사랑 기독교  증오 이기심 배척 우선하게 되었냐  성직자 본분 뭔 지 알고나 있는지  성직자 눈빛 맑아  보기 만해 먼저 존경 하는 마음 생겨  그런데  배부른 성직자 그냥 잡배 못 해	FALSE
이쯤 되면 개신교 자체 문제	FALSE
미이치 늠 법 어겻으 감방 가는거 당연하지  왜 광훈 없는 자리 탐나나  그 믄 같이 가서 기도 하 거  목사 뭐 그리 대단한 인간  괴변 늘어 놓나 결코 니 들 신 니 들  가둘것이니 그 심판 기다리거라  니 들 신 욕 되게 한 죄 값 반듯이 치를 것	FALSE
죄송합니다  저 기독교인 입니다  그러나 전광훈 그 추종자 들 엄밀히 말 해서 기독교인 아닙니다  전광훈 추종 하는 맹신 들일 뿐입니다  저 들 예수 믿는 것 아니라 예수 이용 할 뿐입니다  기독교 소수 입니다  전광훈 보고 기독교 전체 폄하하지 마세요  기독교 용서 해 주세요  더 열심히 세상 섬기겠습니다  세상 빛과 소금 되겠습니다	FALSE
일본 극우 한국 극우 한 통속	FALSE
악의축 하나님  악의 화살 예수  악의 구덩이 예수 쟁이 들  그 외 추종자 들 좀비 들	FALSE
아주 랄 들 하시네 들  어느 교 계 발광 한 답  귀신 들 뭐 하나 몰라  저 잡귀 목사 들 안 잡아가고	FALSE
어렵고 힘든 사람 들 위해 일해 야할 인간 들 온 국민 들 고통 절망 속 몰아 넣고있으니	FALSE
썩은 목사 들	FALSE
목사 같아야 목사  빤스 수집가 ♪♩	FALSE
진리 선포 하지 않고  가짜 뉴스 전하 것 신앙 줄 아는 자 들 목회 포기 정치인 살아라	FALSE
이런 말 차마 입 담고 싶지 않지만 저런 사람 들 목사 것 기독교 얼마나 부패했는지 보여주는 단 적 증거	FALSE
개신교 종교 아니다  쓰레기 들	FALSE
사탄 들 물러가라	FALSE
이 거 봐라  반성 없다니까  광신도 집단  그동안 너무 자유로웠나  방종 자유 구분 없어	FALSE
예수 봐라 네 추종자 들 하는 짓거리	FALSE
정신 들 좀 차리세요 갑자기 가뒀나  형 집행 중 보석 해 준거잖아요  그럼 법 규정 지켜야지 도대체 교 한 테 무슨 낯 무슨 말로 설교 하지요 정부 사회 종교 탄압  우리 나라 코로나  방역 안 하고 환자 많이 나오면 기회 하고 정부 욕 하면서 탄핵 하려고 양심 좀 가집시다	FALSE
대 한 예수교 장로회 대신 총회 대신 총회 임원 들 전염병 테러리스트 들  국민 명령 정부 요것 들 국가보안법 다스리고  국민 힘 이 종자 들 말살 시켜라	FALSE
대신 총회  전광훈 만든 이단 데 맟  그래서 그러는구나  정신 이상자 들	FALSE
목사 목사 나름  의사 의사 나름  검사 검사 나름 이  판사 판사 나름  국민 국민 나름	FALSE
내 주변 개신교 상종 안함	FALSE
신천지 왜 생겨났는지 요즘 기독교 보면 이해 됨	FALSE
여긴 또 모 장로회 장로회 장로회 대신 어쩌구 듣보잡 전광훈 이 목사 생각 하는거 보니 참 여기 목사 들 도 찐 개 찐이네 니 들 하나님 까불면 혼난다고 설교 하냐	FALSE
종교인 과세 언 제 하나요  김진태 의원님	FALSE
이번 집회 군대 동원 해서라도 강력하게 막아 야합니다  종교인 본질 저 버린 저런 단체 들 우리나라 소상 공인 다 죽 있습니다  언제 교회 정치 하기 시작 했는지 알수 없지만 개탄 스럽습니다 저 들 대출받아서 헌금 뜯어내는 사악한 사탄 들입니다  제발 본분 지키길 바랍니다	FALSE
교 계 자 들 전씨 같은 부류	FALSE
이번 코로나 틈타 드러난 국내 인간 바이러스 집단 현황 들 잊어서는 안될것	FALSE
교 계 뭔 단 첸 모르겠으나 이 인간 들 함께 수감 부탁 합니다 빨갱이 못 원숭이 같은 쓰레기 들	FALSE
기독교 상식 적 행동 하세요  부끄러워 죽겠어요	FALSE
전두환 이었으면 니 들 다 죽었을거야	FALSE
너희 들 제발 어디가 예수님 믿는 기독교인 하지말아라 앞 한국 교회 전도 활동 못 한다	FALSE
이참 우리 가족 친적 들 저런 목사 들 교회 가지 말라 설득 해야겠다 예수님 욕 되게 하는자 들이다	FALSE
의사 일베 들 조용해지니 개독 일베 들 또 나오네	FALSE
하나님 우신다  저런 것 들 목회자 하나님 들 먹거 려	FALSE
저 교인 적극 찬성 입니다  전 국민 생명 위협 했고  하나님 이의 영광 커녕 이름 먹 칠했다고  생각 합니다  제발 정신 차리세요	FALSE
대 한 예수교 장로회 코로나 좀비 단체  모조리 소각 시키는게 답  그리고 대한 빼 좀비 들 이건 어때 일본 예수교 장로회	FALSE
그래 코로나 계엄 상황 들어가 접시 물 에코 박고 업어져있어라	FALSE
당신 들 종교인 아니라 테러리스트 들 우리 공동체 을 파괴 하는 사회 악 개독	FALSE
대 한 예수교 장로회  신천지 막상막하 구나	TRUE
가짜 교회  신자 들 이웃 들 국가 조금  생각 한다면  니 들 벌린 결과 보고  종교 탄압 거  기독교 구속 하길 했나 총 쏘길 했나  조용히 집 성경 읽으며 기도 하며  기독교 계속 하라  하느님 교회 계시는게 아니잖아  니 들 종교 빙자 반 문재인 세력 임  국민 들 다 안다  광복절 집회 전 국민 힘들게 했으면  양심 없는것 들  하느님 그만 팔고  차라리 떳떳하게 정치 단 제라 밝혀	FALSE
교회 사회 악  교회 사회 좀비  새벽 지하철 예수 믿으라고 돌아다니 말라  눈 띄지 말라	FALSE
세금 안내 십일조 영업 했음	TRUE
교회 탈 흔 사이비 종교 인지  교회 데 원래 사이비  앞 교회 다닌다는 사람 만나면  정상 아닐꺼란 생각 들꺼 같다	FALSE
교회 탄압 아닙니다 억지 쓰지 마세요 창피합니다  교인 들 다 지켜보고 있다는걸 잊지 마세요	FALSE
그러다 너희 들 조만간 죽 죄 지었다 용서 바랍니다 할거라 장담 한다  너희 종교 신도 씨 말라 갈것 같다  애초 니 들 국가 국민 안녕 안전 따위 관심 없는 쓰레기 들  진짜 목소리 내야 될 정권 하 찍 소리 못 한것 들이 참 좋은 세상 이긴 하나 보네  비겁한 쓰레기 들	FALSE
목사 질 하지말고 정치 하 모 지리 쓰레기 들	FALSE
대한 예수교 장로회  교회 결국 쓰레기 집단 이었군	FALSE
개신교 추방 운동 벌이 자 이슬람 더 원리 주의자 들	FALSE
교회 가면 하나 노 ㅁ 은 없고 먹 사노 ㅁ 만있다	FALSE
기독교 정말 징글징글 하다  저런 쓰레기 들 구원 받으라  어찌 전도 하냐  이중 악마 들	FALSE
개 같 은 소리 자 빠 졌네 미 친 싸이 비 같으니라고	FALSE
이제 종교 청소	FALSE
하나님 혼내는 전씨 뭔들 무섭겠습니까	FALSE
전광훈 종교 나 할애비  쓰레기 들	FALSE
대신 총회 쓰레기 들 모인 곳 니 들 목사 자격 털어 보자 별 ♬♬♪♪♩ ♪♩ 들이 득실 득실하거다 자격 미달 자 들이 태반 일 걸	FALSE
대 신 총회 또 뭔가 이 나라 기독교 사라지길 바라는 사람 들	FALSE
좋게 말 하면 교회 나쁘게 말 하면 희 대의 사기꾼 조희팔 다를게 없음	FALSE
점 마랑 엄마 부대 주씨 진심 사랑 하는 주님 곁 갔으면 좋겠다	FALSE
전광훈 플레이어 일 뿐 배후 쟤 들 엠비때 꾸준히 세 불려 온 것 들	FALSE
미친 종자 들	FALSE
사형 시켜라 ♪♪♩♬♪♪	FALSE
교회 이제 반정부 및 무정부주의자 들 집합 체 신정정치 하려는 즉 중세시대 돌아가려는 단체 반국가단체 교회 신자 들 즉각 전 원 구속 최고 형 다스려 야할것이다	FALSE
한기총 소속 추종 교단 이단 스스로 증명 하는거 임  하나님 까불면 죽어  빤스 내리는가 중요한 잣 대 자칭 목사 란 넘을 비호 다  그럼 같은 족속  이단 맞는거 아닌가	FALSE
나도 성결교회 성도 일부 교인 들 동네 방 견처 럼 행동 들하는지 개탄 스럽다	FALSE
예수 쟁이 들 다 쓸어 버려야	FALSE
구상권 청구  이참 종교 세 신설	FALSE
코로나 확산 저지 하는 선  종교 활동  종교 자유 주장 하며  무고 사람 들 코로나 감염 시키고  광화문 집회 후 일부 죽고 중증 환자 고통 받고 있다  책임져라	FALSE
개 사탄 악마 집단  목 쳐야 된다  지옥 단체 가라	FALSE
가짜 가라 전씨 은근 히 보조 맞추는 보수 교회 들 각성 하 독재정 권 밑 나서서 충성 하다가 찔리는 게 많은 신가 이제 궤변 늘어놓게 개신교회 제각각 이번 사태 통해 저절로 옥석 가려질 것 같아 외려 다행 아 참에 엉터리 목사 들 다 정리 되길 기도 한다	FALSE
완전히 종교 탄압 악질 독재정 권  무슨 법적 근거 구속 하냐  들어 보  완전히 권력 입맛 구속 하는 구나  하나님 심판 받을 것	FALSE
저 는 기독교인  전광훈 씨 구속 찬성 합니다  성직 하나님 주신 축복 입니다  세상 분노 표  자신 의 드러내고 상대편 비난 정죄 하  주신 것 아닐것 입니다  회개 하시고 다시 돌이키시기 바랍니다  그러나 법 원칙 누구  동일한것 입니다  하나님 의법 지키는 자라면  세 상법 당연히 지켜 야합니다  세상 대한 분노 교회  이름 표현 하지 마십시오  어느 누구 그럴 권한 없습니다  민주주의 위해 선 침묵 했던 교회  왜 이리 포악하게 정권 심판 외칩니까	FALSE
ㅋㅋㅋㅋㅋ 목사 꼬붕들 예수 믿거라 사악한 설교 믿지말고	FALSE
한국 교회 사실 상 반정부 단체 헌법 개 조스 아는 반역 단체 저 쓰레기 들 다 청소 하는 수 없다 isis 하고 다른 뭔가 구역질 나 개독 들	FALSE
전부 빤스 내리고 전광훈 앞 엎드려라 너희 들 구세주	FALSE
인간 아닌 갱 속사 사탄 들 평냉 감옥 썩어라  이나라 국민 들 이렇게 힘든 시국 양심 없나	FALSE
와 진짜 정치 교회 정신병 자 많다  니 네 들 부르 짓고 외치는 하느님 통곡 하시겠다	FALSE
진짜 종교 탄압 해야 되는거 아니냐 니 들 인한 피해 어마어마한데 아직도 그런 생각 뿐 이나라 떠나서 살아라	FALSE
종교 너무 커다 목사 뭐 공부 지지리 못 한미 런뚱 들이 신 대 일 반 대학교  행세 하며 정규 대학 졸업 한 것 지성인 행세 개을르 미련 둥이 목사 들 잡 귀신 변신	FALSE
하나님 팔이 들 낚 좀 맙시  제발	FALSE
어떤 사이비 단체 헛소리	FALSE
우리나라 기독교 예수교 종교개혁 필요하다  제발 생명 초점 맞춰라	FALSE
교회 들 전부 회계 조사 정치자금 다 조사해 정교 유착 좀 없애주세요	FALSE
그 노무 광훈이 믿는 종교  탄압 해야 마땅하죠 아니  탄압 아깝소 말살 해야 옳음	FALSE
이런 쓰레기 집단 예수 쟁이	FALSE
이 시국 저런 개 소리 떠드는 자 들 교 계 대표 들 야하 놀랍구나 저 들 머릿속 도대체 뭐 들어있 단말	FALSE
전씨 목사 아니라며 누구 말 믿어야하나	FALSE
정신병 자 개독 들  사탄 마귀 헌금 돈벌레 들	FALSE
아직 상황 파악 안되는 사람 들	FALSE
난 장로교회 제일 싫다	FALSE
전광훈 신  하나님 믿어야지 사이비 목사 신 따르고 있어  신천지 이만 희나 뭐 달라  기독교 망신 그만 시 키 조용히 입 들 닥치고 있어  개념 없는 당신 들 때문 열심히 사는 국민 들 죽음 내 몰리 있는거 눈 깔에 안보  살 꽃 다운 아가씨 버티다 버티다 자살 했는데 당신 들 뉴스 보고 죄책감 안 들 지금 당신 들 국민 들 입힌 피해 몇 만배  당신 아들 딸 손자 손녀 대대손손  이어서 죗값 받길 내 두 손 꼭 모아서 기도 한다  지옥 떨어져라	FALSE
야 이건 무슨 또 또 라이 들이셔 교회 탄압 미친거 아냐 야 진짜 교회 이렇게 멍청한 집단 이었나 뭐 바이러스 릴 부러 환자 만들어 종교 탄압 니 들 하지말라는 짓 안 하면 좋잖아 무슨 개 소리 하고 있어 전광훈 회장 않힌 집단 다 워	FALSE
기독교 야 여기 싫으면 이번 기회 북 꺼져 버려	FALSE
오늘 자 조선일보 호주 임종 집전의 가족 면회 사비 한단다  너희 조선일보 보도 했다	FALSE
이 사람 소속 된 단체 보다 다 들 참 안 됐다 그걸 알고도 그랬으면 만일 이런 짓 나쁜 일인 줄 아직도 모르고 이렇게 데모 하면 정말 답 없다 한국 교회 댁 들 말 먹는 중이 우 짤 망할 짓 그리 열심히 하노	FALSE
요즘 너희 같은 놈 들 때문  직장 교회 다니는 사람 들 우선 적  짤리 는거 모르냐  나 앞 교회 다닌다면 채용 안 할거다	FALSE
느그 들 국민 반납 떠나라  보호 해줄 필요 없는 종자 들  존중 해줄 때 아가리 닫아라  종교 무슨 특권 둘 아 나본 데  그냥 느그 들 일개 모임	FALSE
법도 다무시하고 자기 들 마음대로 하네 자기 들 마치 인간 위 있는 초 법적 존재 착각 있네 나라 법질서 무력 화하는 세력 들 몽둥이 다스릴 수 없네	FALSE
진짜 악마 집단 따로 없다 요즘 보면 저 것 들 다 지옥 떨어질거 같다	FALSE
교 계 단체 그것 알고싶다 보니 한기총 전 회장 들 전광훈 용돈 받아 쓰던데 그래서 그러나 니 들 진자 악마 집단	FALSE
저 교단 그렇습니다 다른 교단 들 싸잡아 말씀 하지 말 주세요	FALSE
국내 개신교 전부 이단 사이비 된것 같다 전 국민 코로나 바이러스 위험 빠뜨린 자를 목사 라며 종교 탄압 두둔 하는 꼴	FALSE
저 악의 무리 들 하나님 영화롭게 하긴 커녕 이름  똥 칠만 해대 무리 들 신의 노여움 있기를	FALSE
와 피곤한 종자 들	FALSE
너희 무슨 종교 이웃 해 끼치면서 종교 지껄여 부끄러움 모르는 자 들 너희 정권 비판 있는 게 아니라 오히려 정권 옹호 하는 자 들 걸 아직도 모르는가	FALSE
예수님 그 당시 로마 압제 로마 향 해 정치 공세 펴지 않았다 가난하고 힘없는 민초 들 정의 자비 믿음 가르쳤다 오히려 정치 적 기득권 들 향 해 돌이키길 강조 했다고 전광훈 일부 목사 들 제발 선동 질 그만하고 자신 돌아보고 예수 마음 읽기를	FALSE
공모자 들 알아서 기어 나오네 ㅋㅋㅋㅋㅋ	FALSE
조상 님 들 선견지명 파이어 그 를 탁 치 간다 이 땅 예수 쟁이 들 뿌리 못 내리게 잡아 죽이시던 조상 님 들 못 후손 들 용서 하세요 ㅠ	FALSE
이련 양 아치 무슨 목사  이 것 전광훈 이처 렴 구속 하	FALSE
국가 전복 세력 입니다 싸 그리 법 집행 합시다 사회 악 들입니다	FALSE
종교  니 종교 본질 아냐  따를 종 가르칠 교  너 너 따르 게  못 된것만 가르쳤으니  종교 탄압 아니고  사 술청 산이 맞다  고결한 종교 산 앙 더럽히지마라	FALSE
나 진짜 문재인 진짜 계엄령 선포 해서 박정희 전두환 식 저 것 들 조져도 박수 처 줄듯	FALSE
대 신파 대한 기독교 계 전체 평가 없냐 이단 아니냐 판단 조 올라 좋아하는 교회 높으신 분들 입 닫고 할 일 안 하면 개신교 전체 욕먹어도 어쩔 수 없지	FALSE
대신 잘 해라  쓰레기 취급 받기 싫으면  신 믿으 랬 더니 광훈  를 따르면 되겠니	FALSE
저기 동조 하는것 들은 테러범 들	FALSE
진짜 신천지 더한 집단	FALSE
부탁 이 나라 나가줘라  제발 부탁 너희 무서우면 가만있고  만만하면 저렇게 덤비고 있는 지금 과거 기억 못 하니 선택 적 순교 그럼 세금 낼	FALSE
정신병 자 둘 같으니라 구 니놈 둘 예수 알 가라지 들	FALSE
한국 개신교 쓰레기 들 몰아내야 한다	FALSE
예수교 장로회 교단 정리 좀 해 지 들 끼리 목사 안수 주고 받고 하면서 수틀 리 교단 들어서 뭐 하는 짓거리 신학 제대로 안 배우고 엉터리 신 학원 만들어서 암튼 문제	FALSE
대신 장로회  참 더럽게 미 첫 다  전광훈 목사 칭 하  니 들 개 못 국민  장로회 교회 완전히 사회  배척 하자  참 저 그 손자 들 못 한자 들	FALSE
정상 적 목사 없는지	FALSE
예수님 욕 보이  국가 국민 안전 해 되는  천박한 사이비 개독 사기꾼  기독교 혐오 기름 부어 대 보수 탈 쓴 유신 우상숭배 광신도 들  하나같이 막무가내 진상 꼴통 들	FALSE
대다수 기독교도 신자 들 전광훈 재 구속 환영 합니다  적그리스도 악마 목자 위장 하여 사회 신자 악의 구렁텅이 이끄는 것 묵 할 수 없습니다  광 후니 하나님 심판	FALSE
대 신 법 정부 투쟁 위원회 문제 전부 아닌데 전부 부풀리는 기자 문제 군 교단 전광훈 이단 보고 있음 기사 똑바로 써라	FALSE
개신교 대부분 전광훈 씨 목사 생각 하지 않습니다	FALSE
대 한 예수교 장로회  저 들 집회 인해 전국 적 얼마나 많은 자영 업자 들 지금 피 눈물 흘리며 버티고 있는지도 모르는 냉혈안듵 하나님 팔 악마 놀음 하는 놈 들	FALSE
개신교 어디 갈래  오만 방자 더 눈 뜨고 못 보겠네  가훈 개신교 불신 물려주겠다	FALSE
교 계 단체 돈 밝히는 사이비 겠지 전광훈 사기꾼	FALSE
이단 보면 된다 그냥 관심 두지마라 관종 들 어디 써 먹겠노 신도 예 수 이름 사기 치겠지 목잔 도둑 인 자신 알거고 앞 서면 알겠지 궁금한게 미안한 마음 없는지 하기사 화인 맞은 양심 미안함이 있을까	FALSE
ㅎㅎ 허  간댕이가 완전 기독교 폐교	FALSE
옳은 때 옳은 방법 했으면 누가 뭐라해  그리고 어디가 탄압 법대 하는건데	FALSE
모태 신앙 사이비종교 계 난리 구나  양적 성장해서 질적 퇴보하고	FALSE
전광훈 이 재림 예수  그 거 몰랐어 모르면 말 하 덜마  갸 이제 순교 해야해  잘 가라 재림예수 광 후니 ㅠ	FALSE
대 신 총회 전광훈 이 속 해있는 군소 교단 ♬♬ 들임	FALSE
저 것 들 집단 폐기 처분 해야 한다	FALSE
빨리 죽어서 천 당가 내 특별히 연락 해 둘	FALSE
미개 미신 수준 이보 낫	FALSE
이란 ♪ ♬♩♪♪ 뉴스 쓰지도 말아주세요	FALSE
전광훈 이 썩어 빠진게 아니구나 나 엑 시 교인 사랑 제 일 교회 교인 들 안타깝더니 신학 한 목사 님 들이 더 정신 나갔구나 목사 님 들 여기 이러 심 아니 되옵니다 ㅠㅠ 세상 어떻게 돌아가려구	FALSE
♩♩ 몽둥이 답  당장 구 속 해	FALSE
눈 없나 귀가 없나 뇌 없나  구상권 청구 반드시 받아내시길	FALSE
대신 총회 들어 보도 못 교단  전광훈 이 속 해 있는 교단  그것 종교 탄압 하냐  쓸어 버리면 되지	FALSE
이런 인간 들 때문 교회 다닌다는것이 창피하다 니 들 목사 기도 말씀 연구 묵상 전념 해야 할 목사 들 정치 판 물들어서 개 소리 하고 있으니 누가 너희 들 말 듣겠니 건방진것 들  군사정권 기대어 그동안 잘 컷  하나님 심판 있을지어다	FALSE
아직 순교 안 했어 순교 한다며	FALSE
우리 집 강아지 웃겟다	FALSE
목사 말 빼고 지껄여라 ♩♪ 들아	FALSE
쓰레기 들 괴물 척살 되어야하는데 뭔 말 많아	FALSE
전광훈 씨 국민 탄압 하지 마세요	FALSE
저런 교인 들 인해 정말 참 신앙 욕 먹고 있다는걸 아직도 모르내  목사 교회 신도  교회 회사  목사 사장  신도 직원  다 들 개인 사업 하면서 왜 세금 안 내노  교회 세금 내  이 쓰레기 들  교회 교자 만들어도 치가 떨리고  교회 목사 목자 들어도 피 꺼 꾸로 솟고  교회 신도 신자 들어도 살기 느낀다  교회 좀 없애라	FALSE
저런 자 들 정권 잡았다 생각 해보라  기독교 외 사람 들 모두 빨갱이 몰려 총살 당한다  이북 김씨 일가 하는게 똑같은 기독교  김일성 이나 목사 세뇌 시켜 좀비 만들어 통치 낙엽 타고 강 건너는 김일성 솔방울 수류탄 만든 김일성  맨발 강 건너는 예수 죽어서 부활 하는 예수 말 안되는 사기 현혹 사람 바보 만드는건 기독교 이북 공산당 이나 똑 같다는걸 알아야 한다  함부로 교회 가지마라 당신 인생 ♩ 된다	FALSE
이참 사이비 종교 집단 조사 하자 ㅏㅏㅏㅏ	FALSE
나이 먹고 정신차려라  교인 답 행동 코로나 전세계 격 있다  제발 나서지마라  우리 마스크 벗고 살고싶다	FALSE
늬들 탄압 아니라 제거 당해야해	FALSE
광 후니 니 들 마누라 보고 빤츠 내 라라 했을 낀데 그래도 ♪♪ 타고 졸졸졸 오리 새끼 아니고 늑때따 절 쩔쩔 코 껴 가는 얌 세이 시 키 들	FALSE
이러니 교회 욕 안 할수 있나	FALSE
감사합니다 니 들 덕 개독 그만둔다는 사람 늘어납니다	FALSE
Korean IS 코리안 알카에다 개신교 수장 들 국가보안법 처벌 되 기를	FALSE
단순 종교 집회 아니니까 그러는거야  눈 귀 주머니 넣고 다니냐 그리고 위기  다 지켜야지 그 와중 정치가 어 쩌 떠들어 대냐 그저 우리 편아니면 잡아먹듯	FALSE
초 ㅇ 카 ㄹ 장갑 ㅊㅏ 로  밀어 버리고 싶다  돈 노예 들	FALSE
더 이상 개신교 욕 보이지 마라	FALSE
인간 들 종교 탄압 좋아하네  니 네 들 믿는게 종교  하느님 빙자 사이비 악마 들	FALSE
에잇 예수교 장로회 먹사 넘 들아 너희 교회 예수 신도 들 전염병 걸려 뒤지라 가르치냐 그 져 돈 쳐 먹을 생각 교회 불 사르 지옥 가라	FALSE
드뎌 본진 둘 나서는가 행동 대장 광훈 사라지니 본 모습 보아는군 구래 니 들 🐕 독 한다	FALSE
가계 단체 정치 하는 장로 단체 겠지 아 이 젠 코로나 단체	FALSE
저 것 들 다 이단  전광훈 이미 목사 아닌데 추종 따르다니  정말 성경 읅 어 봤나  종교 탄압  험 소리 좀 ㅓ 그만 지 컬여  정말 부끄럽지도 않냐  기독교 대표 나대지 마라  누가 니 네 기됵교 대표 했냐 정말 욕 나온다  정신 좀 차려	FALSE
대 한 예수교 장로회	FALSE
저 것 들 하나님 팔아서 월급 받아 광화문 집회 정치 하는 가증 넘 들	FALSE
교회 쓰레기 들 ㅗㅗㅗㅗㅗㅗㅗ	FALSE
사이비 단체 겠지  느그 들 하느님 그리 시키든  남 피해 줘가면서 돈 벌어 쳐 먹으라고	FALSE
국민 가 광 후니 구속 원하잖아	FALSE
그럴 힘 있으면 어려운 주변 사람 들 살펴라 육신 멀쩡한 것 들 꼴 무슨 대단한 견장 찬 것 행동 하는 꼬 라지 ㅉㅉ 부끄러움 도 없는 것 들	FALSE
놀고 자빠졌다 니 들 예수 쟁이 있을지언정 예수 없다	FALSE
광훈 이후 대한민국 교회 이익 집단  전락 해 버렸다 국민 들 외면 해 버릴것이다  그 들 리그 일 뿐	FALSE
저 것 들 교 계 아니거든	FALSE
아 후 그냥 교회 세무조사 한번 들어갑시다 개 짓는것도 정도 있어야지	FALSE
병어 ㅓ 엉 시신 들 육 갑 떨고 자빠졌네	FALSE
장로교 이단	FALSE
그래서 개독 이	FALSE
개꼴깝 들 떨고 자빠졋다	FALSE
라이  말 하기 도실 타	FALSE
종교 탄압 이면 교 계 단체 니 들 이미 끝났어야해 박정희 전두환 웃는다	FALSE
제 의 전광훈	FALSE
니 들 어디 섬 사서 니 들 끼리 살아라  우리 니 들 때문 고통 받으며 불안하게 살고싶지 않다 그 곳 종교 탄압 말 없을 것	FALSE
목사 샠 는 법 어겨도 된다는건  어디서 배워 먹었느냐 개목 들	FALSE
한국 교회 쓰레기	FALSE
뭔 짓 해도 아닥 모른체 하란 말  안 그러면 종교 탄압	FALSE
너희 교 계 자정 능력 없어 종교 계 리 어려움 감수 공권력 그러는거야  철권 독재 시대 전두환 때 끽소리 못 하다가 세상 좋아지니 이제 떠드는거냐 그냥 찌그러져 있어라 정말 하나님 심판 하시 기전	FALSE
욕 욕 되로 먹으면서 아직 정신 못 차려는지요 그저 씁 슬하	FALSE
야 너희 들 목사 맞느냐 야 이 놈 들 너희 들 신도 들 돈 빼앚는 터 인간 이하	FALSE
모두 쓸어 버리에요 교회 가드 던지 비정상 이 활보 하 늣 세 상이 되어 버렸네요 법 물렁해서 그러네요 모두 구속 하세요	FALSE
목사 안수 허위 판결 나 급히 탈출 해서 스스로 세운 교단 대신 아니었나	FALSE
이 들 지칭 한 대로 현 정부 히틀러 식 전체주의 국가 규정 했으니 이 것 들 모조리 잡아다 광화문 공개 총살 시키자 말 한 대로 히틀러 면모 한번 보여줘아 한다 당장 시행 하	FALSE
저 이상한 목사 하나 관리 못 하면서 무슨 소리 하냐  다시 로마 네로 황제 나와야 정신 차리겠니 ㅉㅉㅉㅉㅉㅉㅉ	FALSE
오이지 생긴 저 애 맨날 옆 붙어 다녀  이 당 저당 옮겨다니더니 결국 도라이 단체 가서 한자리 할 줄 아 보지	FALSE
사이비 들	FALSE
어떤 교 계 너 나도 목사 만들어 주는 장로교 계  각 동 마다 개 씩 교회 노회 란 것 만들어 지 들 끼리 목사 만들어 주는 장로교 들었다  이 정상 적 목사	FALSE
질병 테러범 들	FALSE
교 계 이야기 하지말고 전광훈 따르는 자라고하시오  당신 들 하는 말 정말 부끄럽소이다	FALSE
♪♬ 들 패거리 들 집단	FALSE
기독교인 정말 부끄럽다	FALSE
정신차려라 먹사 들아  빛 커녕 암 적 존재 들	FALSE
하 개신교 너무 미개하다	FALSE
개독교 들 말 개 짖는 소리 못 하구나 예수 하나님 있다면 이런 ♩♪♪♬♬♪ 들 뭐라 할지 궁금하네	FALSE
유유상종 끼리끼리 잘 논다 대신 총회 거기 임원 놈 들 궁민 짐 똑 같다	FALSE
종교 탄압 같은 소리 하고 있어 타락 한 것 종교 계	FALSE
무슨 교회 탄압 너 구속 시켜서 콩밥 머보 반 서해 너희 들 종교 아니고 사 딴 의 무리 들 국가 전복 시킬 목적 집회 발광하냐	FALSE
예 장이 정말 많이 썩었구나 아니지 옛날 썩엏는데 이제 드러나는거겠지 ㅉㅉㅉ  하나님 소돔 고모라 한국 교회 불 태울 날 올것이다	FALSE
이 것 들 정신 정상 아닌듯  미안하다 사과 커녕 적반하장 격  양심 없는 인간 들 니 들 신앙 인  개도 웃겠다	FALSE
저 교회 다니는 충 들 뭔 지 ᆢ 그래서 요즘 젊은 세대 들 교회 멀리 하는거다 ᆢ 저 들 호의호식 하며 예수 파는 ᆢ 항상 낮은 곳 임하라는 그 분 말씀 좀 들어라 ᆢ 가벼야 원 옷 입고 말 익은 이를 조심 하라	FALSE
니 얼굴 마담 잡혀가니 ㅡ ♩♪♪ ♬♩ 하는구나 ㅋㅋㅋ  대한민국 국교 개신교 천주교 불교 기타 다른 종교 가만 있는데 지 들만 ♪♪ 하내	FALSE
전광훈 만든 교단	FALSE
정말 바이러스 계엄령 내려서 이런 꼴통 같은 인간 바이러스 같은 넘 들 제다 잡아 국 끓여 쓰면 좋겠다  절차 방법 민주주의 이념 같혀 이도 저 도 못 방치 하는 것 민주주의 이니다  국가 비상 사태 준 행동지침 신속 처리 국민 들 건강 생명 보호 하는 적극 적 행위  언제 이런 말 안되는 꼴 국민 생명 위험 노출 시키며  방관 하는지 모르겠다  군사정권 아니지만 비상 사태 준 하는 강경함이 없다 보니 나라 혼란 속 좀 먹는 벌레 들 나와 설친 달까 정먄 박멸 하는데 이 정권 시간 다 쓴다 고해 이런 식 해결 불가	FALSE
진짜 이슬람 공산당 보다 개신교 더 싫어 몸서리 쳐진다	FALSE
판사 잡아들인거지 풀어 준것도 판사 문재인 대통령 아무 관계 없으니 괜히 미워하지마라	FALSE
나도 교인 할말이 없다 너희 들 모두 사탄 들	FALSE
그만 꺼져 제대로 된 교회 그만 욕먹이고	FALSE
종교 탄압  이렇게 국민 들 피해 주면서 너희 들 진정한 교인  사람 양심 있어야지 예수님 그렇게 하라 고 시키던  교회 빙자 사기꾼 들	FALSE
전광훈 똘 들 동원령 내렸군  기독교 말 뺐으면 한다  왜 기독교 니 들 개인 신인것처럼 행세 하냐  국가 말 안 듣는 자 들 신의 말씀 듣냐  기독교 빼고 전광훈 이교회 관련 자 들 해	FALSE
전광훈 씨 재수감 되는게 무슨 종교 탄압  종교 대표 말 꺼내지 마라 하늘 내려다 보고 있다 조심하시고	FALSE
이런 종교 활동  정말 필요하니  사람 이롭게 하는것이 종교 역활 아닌가  사람 죽게하고 힘들 게  정말 필요한가	FALSE
대한민국 모든 교회 완전 정화 시켜야 한 닷  불교 천주교 제외 일부 대형 교회 들 정부 협조  놔두고 말종 집단 마귀 들 득실 거리 추악한  개신교회 죄다 없애야 한 닷  반드시 ㅠ	FALSE
종교 탄 합 하지마라 자유 대한민국 언제 천주교 국교 됐냐 저 놈 문 쥐 이 믿는다고 천주교 국교 대한민국 종교의자유 있는 나라 핍박하지마라 종교 탄 합 사절 전 목사 님 석방 시켜라 왜죄 없는 분 가두냐	FALSE
이 것 들 학마	TRUE
누가 종교 탄압 하나 국민 건강 위해 집회 자체 해달라는데 종교 집회 자유 국민 건강 절대로 우선할수 없다	FALSE
아이 ㅆ ㅍ 목사 새 끼들 좀가만이 쳐 박혀있어라 너 들 이재 장사 망했어 어떤 골 빠진 놈 교회 가나 ㅆ ㅂ 주고 돈 주고 마약 주고 웃기는 종자 요	FALSE
이런 세력 백골단 답  머리 터지게 두 들 겨 맞아야 정신차린다	FALSE
너희 장로회 목사 들 전광훈 돈 받았다며 PD 수첩 나오더라 비호 해주는거냐	FALSE
예수님 사랑 이 땅 남고 한국 교회 이 땅 없어져야 합니다 모두 한국 교회 없어지는데 동 의합 예 동의 합니다	FALSE
아  싸이코 패스	FALSE
종교 탄압  터 진입  국민 사지 몰아 낸 넘 들이  인간 기생충 들 박멸 합시다  전광훈 이 사람  세 살애 못 넘이	FALSE
개 못 쓰레기 목사 들	FALSE
돈 벌레 늙다리 사이비 목사 들  ㅋ	FALSE
이단 어쪼구 하더니 결국 한 몸  주 예수	FALSE
목사 의사 정말 어쩌다가	FALSE
진짜 종교 쟁이 들은 정신병 자만 있냐 ㅉㅉ	FALSE
종교 탄압  니 들 종교  언제 신천지 다르다면  다르긴 하더라  더하면 더했지  쪽 수많다고 아주  질 r 도 풍년 이	FALSE
야 이 쓰레기 들 니 들 그러고도 예수님 팔 호의호식 하며 살것지 근데 니 들 행동 하나님 좋아하실까 그러고도 니 들 교 계 대표 하는 목사 행세 하냐 드러운 ㅅㄲ 들아	FALSE
그럼 기독교  국가 인정 하지 않는  전복 세력 이었단 말	FALSE
통신사 기자 들 다 외 그러지  아무나 뽑나	FALSE
곳곳 화나는 것 들 천 지구	FALSE
ㅋㅋㅋㅋㅋ 종교 쟁이 머 대단한거라고 거창하게 ㅋㅋ  아니 능력 쥐쁠 교회 댕 긴것 들이 머 ㅋㅋㅋㅋㅋ	FALSE
개목 아지 끌듯이 개 목사 들 목줄 걸어서 광화문 끌고오라	FALSE
하 할말이 없다	FALSE
ㅎㅎ 하느님 지 손 죽는다는 사람 목사 종교 탄압	FALSE
한국 먹사 들 징그럽다	FALSE
예수님 가르침 너 이웃 죽 이 디	FALSE
진짜 탄압 안당 해봤구나	FALSE
저 주장 하는 교 계 단체 들 잡아들여서 콩밥 먹여야하는데	FALSE
자기 교회 안 그렇다 일부 그렇다 하고 맨날 댓글 교회 쟁이 들 그러드 결국 니 식구 맞재	FALSE
수고 했 따  집 가 여 신도 들 몸매 감상 하드  음 얘	FALSE
이런 걸 기사 랍시고 쓰지도 마라  추접 스럽다	FALSE
법 어겼잖아 그래서 벌 받는거고 벽보 이야기 하는게 더 났겠다	FALSE
돈 때운에 그러는거 임  온라인 성금 걷으면 될것을  꼭 이래야만 돈 걷치니  그만 좀 합시다  돈 코로나 종식 되면 그때 걷읍시다	FALSE
저런 목사 목사 똑 같은 것 들  편 들어 주는 거  망국 개신교 불 댕기	FALSE
사이비 교주 테러 단체 종교 탄압 싸 그리 박멸 시키자	FALSE
가지 가지 다	FALSE
어떻게 저런 논리 펼칠 수가 있는 건지  본인 들 인해 피해 입은 수많은 사람 들 아픔 고통 전혀 생각 지를 않는구나  이번 코로나 사건 인해 당신 들 본 모습 알 된 점 그거 하나 정말 다행 본다	FALSE
어후 ㅡ 왜 교회 그 모양 됐나요	TRUE
종교 과세 해야 된다	FALSE
개신교  까세요	FALSE
우리나라 교회 얼마나 썩어는지     새삼 느끼게 되네요     씁쓸합니다	FALSE
이 지경 만들고 종교 탄압  분노 치밀어	FALSE
이참 기독교 전쟁 교회 다 폭파 시키자	FALSE
군사독재 시절 민주주의 인권 대해 한마디 말 하지 못 저 들 독재자 위해 호 사스 란 호텔 모여 온갖 아첨 떨며 기도 해 주던 자 들 니 네 들 아니었냐 참을	FALSE
대 한 예수교 장로회 대신 총회 임원 들 누구신지 거짓 가짜 뉴스 만들어내고 나라 엎으려 하는 세력 들 같네요	FALSE
대신 총회 임원 님 들  제발 예수 믿으세요  예수  네 이웃 사랑 하 하지 않았나요 부탁 드립니다	FALSE
교 계란 표현 쓰지마라 찌끄레기들	FALSE
미친 먹사 들  헌금 밝히고  국민 들 바보 줄 아는	FALSE
개독 들 반 성 문 작성중 꺼듯 하면 신도 성폭행 추핸 자금 횡령 정치 개입 이 것 들 표 많이 가지 있다고 내버려 두는게 문제 많은거지 개독 목사 들 굿 한번 하세요 진중권 그 아들 들 모야 그러면 ♪♩ 되면서 잘 설꺼요 그 리하 메 성폭행 들하고 모 여서 여 신 돌 들 꼬득 돈 헌금 받고 갈취 하 듯 가정방문 기도 해주 메 손잡아주고 멋진 개독 목사 들 구 세 주일 거여 중 권 이 예기 해서 까 달라 고해 포경	FALSE
악한 사람 들	FALSE
이번 보수 개신교 계 뿌리 뽑혀야 한다  전광훈 빤스 목사 실제 배후 쓰 레기들	FALSE
예수 믿는다는 s 끼 들 국민 뽑은 한 나라 대통령 욕 이나 정치 개입 이나라   예수 쟁이 너희 들 좌지우지 하는  그런 나라 왜 교회 기도 한다랍시고 침 튀는 짖 거리 들 해서  코로나 바이러스 퍼뜨려 나라 어렵게 만드냐 그리고 목사 너희 들 세금 제대로 내냐 나라  망해 먹는 교가 있으니 그걸 믿고  따르는 신도 들 정신 차리시오  예수 믿어야지 사기꾼 목사 믿지 마시오 그리고 국민 중요 합니다 제발 바이러스 옮기지 마시고	FALSE
종교 탄압  살다 보니 별 소리 다 든는구나	FALSE
제 정신 아닌 단체 구만	FALSE
대신 총회 전광훈 만든 거 아닌가요	FALSE
참 kasaaki 들	FALSE
예수 쟁이 들 정신병 자 전광훈 닮아가는거지 또 라이 들	FALSE
어찌 하 오 리까  이 기적 기독교 단체  무슨 종교 탄압  광훈 짓 보고  정신 들 못 차리고  언 제 나철 들 들런  정신차려라 인간 들  ××× ×	FALSE
목사 하는 이 들 전광훈 이 똑 같은 소리 들 하고 있구나  하나님 영광 이미 한국 교회 떠났다	FALSE
돌아이 들 단체 미쳤구나 저런것 들을 교인 ㅉㅉ	FALSE
소상 공인 죽는 소리 계속 뉴스 나오는데 니 들 다니는 교회 다 들 부자 들 다니나 보네 아직도 종교 자유 운운을 하다니 니 들 같은 한국인 맞냐 걍 일본 꺼져라	FALSE
이런 양 아치 쓰레기 들  주 댕 닥치고 자중 해라  자유 대한민국 니 개독 장로 들 말 먹으려 하냐  더럽고 추악한 짓거리 당장 중단 회개 해  아니면 하느님 절대로 용서 치 않을거다	FALSE
염소 대가리 섬겨라	FALSE
정신 들 차리시요  니 들 때문 내 가게 주 째  문도 못 열고 계속 적자  보고있다	FALSE
기독교 싫다 같과 속이 다른 집단	FALSE
말 아닌 소리 무슨 종교 탄압 개 소리 지껄이지마  예수님 오시 너희 교단 놈 들 심판 받고 바로 지옥  떨어진다	FALSE
종교 탄압  전두환 때 처럼 해봐야 정신 차리지  그땐 찍 소리 못 하던것 들이  그 당시 종교 천주교 절 뿐이었다고 생각 하지만	FALSE
교 계 하지마라 전체 기독교 오해 다 전광훈 소속 된 소규모 극 보수 교회 들 모인 집단 일 뿐	FALSE
이 시 키 들 뒈질레 종교 탄압 뭔 지 보여줘	FALSE
법대 합시다	TRUE
죄 지었으면 그 따른 엄중한 처벌  받는것이 맞다  종교 빙자 하여 국민 들 반하는 모든  행동 책임 따른다는것을 명 심하길	FALSE
정신 병자 들	FALSE
대한 예수교 장로회 이름 달질 말던가  성경 니 이웃 바이러스 옮기라고 되어 있디	FALSE
사이비 종교 지구 떠나라	FALSE
완전 인권 침해	FALSE
종교  장사	FALSE
인생 걸러 야할 종교인 어디 뼈 저리 느꼈다	FALSE
교회 하지말고 대 신정당 하고 시끄럽게 하세요	FALSE
개신교 전 목사 문 정부 퇴진 집회 하여  죽 싶었을 터  마침 코로나 확진 경계 때 이를 이용 전 목사 와 교회 죽이는 꼴  종교 차원 집회 목적 종교 탄압 분리 하여 생각 해야 할것이다	FALSE
♩♬♪♪♬ 이 너무 많네	TRUE
하나님 도전 너희 목사 들 용서 치 않으리라	FALSE
종교 정치 뛰어들면 바로 팽 당한다 지금 개신교 너무 나갔다 앞 그러면 개신교 전체 팽 당할거다	FALSE
사회 혼란 기 구시대 적 방식 도움 될 수 있을듯 누구 지금 선배 들 골수 쌓아 만들어 온 민주주의 결실 역행 하는거 아니냐고 하는데 검찰 의사 기레기 ♩ 하고 교회 야당 보수 꼴통 늙은이 들 저 ♪♩ 하 는걸 보면 차라리 다시 그 시대 돌아가 피 숙청 하고 끽소리 못 하게 반대 위 반대 못 하게 사형제 도도 부활 하는 미친 생각 해본다 지금 모두 모든 미쳐서 돌아가는 세 상인 듯	FALSE
나 교회 안 떠나려고 어떻 게 교회 계속 다니려고 안간힘 쓰는 개신교 인 마치 벼랑 끝 간신히 붙들고 있는 손 차 버리는 형국 ㅠㅠ	FALSE
광훈이 옥 쑨이하고 했을까 안 했을까  했겠지 표시 안나는데  그래야만 천 당 간다 개애돈 교리	FALSE
이 자슥들 바리 러스 집단  오늘 저기 나온 놈둘 코로나 검사 해보가 ㅏ 랍니다	FALSE
코로나 전도사 전과 후니 만든 종단	FALSE
전광훈 그 추종자 들 한심하지만 이런 쓰레기 사를 쓰레기 자 들이 더 큰 문제	FALSE
사회 악 된 전국 교회 다 폐쇄하	FALSE
전광훈 이 성직자 우리  나라 사람 전부 성직자  닌 사람 있나요	FALSE
꼴통 교회 이름 밝히고 견 소리 하 거 유령 단체 이름 뒤 쏠라닥 거리	FALSE
난 예전 개신교 너무 싫었어요 교인 들 헌금 받아 지 새끼 들 지 가족 들 입히고 먹이 유학 그렇게 다 들 떵떵거리 그런 목사 찾아가는 교인 들 정상 안 보임 정말 이번 보니 내 판단 살면서 최고 잘 한일	FALSE
이러니 개독 교란 소리 듣지  글구 뭔 놈 종파 이리 많아 어차피 헌금 걷어 운영 하면서 예 수 팔이 들 정말 해도 너무하네  아무 죄 없다는 예수 죄인 만드는건 바로 당신 들 예 수 팔이 들	FALSE
그리고 국제 적 저 사이비종교 한 명  파국 된게 외신 나오는데 얼마나 나라 망신 시켜야	FALSE
개신교 들 모두 정신병 자구  대체 종교 탄압 어떤 것 알 헛소리 하나	FALSE
교 계 단체 그 사람 들 교독교 계 대표 입 기자 님	FALSE
테러 단체 수준  하나님 까불면 죽어라고 신성모독 하는 목사 지지 해 하나님 어떤 저주 내릴지	FALSE
탄압 좋아하네 참 좋은 세상 이런 소 리해 놔두는 세상	FALSE
바이러스 전광훈 바이러스 국민 흠	FALSE
ㅋㅋㅋ 개콘 푸하하하	FALSE
이 사람 들 느낌 없어 전혀  이해 할수 없는 희안한 무리	FALSE
계엄령 내리고 다 때려 잡자  저 사이비 들 이미 계엄령 하는데  진짜 계엄령 국민 지 키달	FALSE
갑 들 떨고 있네  하나님 역사 있을것이다	FALSE
이 새끼 들 범인 전광훈 뒤 조종 하는 놈 들	FALSE
참는데도 한계 있다 전광훈 비롯 극우 사이비 기독교 계 코로나 아니였다면 촛불 불탈것이다	FALSE
목사 잘린거잖아요  면상 보기 싫어요  실실 웃는것 악마 같어요	FALSE
사회 악 교회 목사 친일파 당 일베	FALSE
진짜 미쳤네 왜 이러지 ᆢ  저 또 라이 같은 녀석 못 해보나  무슨 약점 있나 ᆢ  다 들 정상 찾으십시다	FALSE
헐 종교 탄압 이 그럼 그대 들 국가 테러 중	FALSE
한국 교회 현주소 입니다 어제 오늘 일이 아니고 아주 오래전 부터 저랬어요	FALSE
듣보잡 대신 총회  신천지 같은 이 단 종파	FALSE
광화문 집회 자 들 교회 들 나라 경제 망치 있구나	FALSE
교회 패망 선언 하는구나	FALSE
기독교 건드리 믄  쫄 딱 망한다	FALSE
멍청한데는 약 없다	FALSE
종교 탄 합 ♪♪ 해 이번 기회 확실히 알았음 교회 다닐 곳 못 됨 딸 아들 교화 다 끊었음 차라리 내 자신 믿자	FALSE
당신 들 때문 예수 슬퍼 하신다	FALSE
하나님 위 군림 하시는 분  ㅎ ㅎ 그럼 뭐라 불러야 하지	TRUE
아직 정신 들 못 차린 개목 들 잘 들어라  니 덜 지옥 행 특급 열차 탈것  마씨 친히 기다리니 사양 어서 들 가거라  뭔 말 알것냐 급사 한다는 말	FALSE
이러니 개 dog 소릴 듣지	FALSE
속죄 반성 해라 무조건 잘 못 했다 고해 네 이웃 들	FALSE
목사 사람 들 어떻게 이럴수 있지  양심 없고 부끄러움 모르는 수준 이하 사람 들임을 계속 느끼고 있다	FALSE
목사 죄 지 어도 처벌 못 하는거냐 만만한게 종교 탄압 그러니까 니 들 욕 쳐 먹는거야	FALSE
종교 탄압 한 게 도대체 뭐  종교 탄압 연관 성 도 없다  정신 병자 들 아닌가	FALSE
대한 예수교 장로회	FALSE
어휴 정말 ♬♪♪ ♩♩ 들 많네 ㅉㅉ	FALSE
자영 업자 피 눈물 곡 소리 안 들리나	FALSE
아 기독교 종말 보이네요	FALSE
쓰레기 소각 해라	FALSE
돈 받은거 이제 효과 나오는구나	TRUE
순교 시켜야 된다	TRUE
이런 x 친것 들이	FALSE
하나님 까불면 나 혼난다는 전광훈 쓰레기 연설 한심한 목사 들 이 바로 신성 모독	FALSE
니 들 정신차릴라면 진짜 멀었구나  라이 종교 탄압 같은 소리 있네 ㅉㅉ	FALSE
사이비 종교 단체 어디서 종교 탄압 단어 입 올 리나	FALSE
그래 계속 불지 펴줘라 국민 짐당 없어지게 ♥	FALSE
비상계엄령 발 동해	FALSE
뭐 이런 일이 제 정신 어려운 시기 협조 해라  욕 나온다	FALSE
교회 세우려면 허가 받도록 하고 종교 단체 기 부금 세금 감면 대신 중과세 하는 것 정책 바꿔라	FALSE
예수 쟁이 들은 전부 정신병 자	FALSE
ㄱ ㅐ 독 들 탄압 뭐 가차 없이 박멸 하자	FALSE
저런 교회 정말 지긋지긋하다	FALSE
대신 측 그 면면 알 있다 두둔 할것을 두든 해야지 전광훈 같은 사이비 하나님 까불 연 죽어 정치 꾼 사기꾼  정신 이상자 이런 자 두둔 하는 대신 측 속 내 뮌  대한민국 기독교 같이 말 먹자는 건가	FALSE
덮어 씌우는 천재 들  시프 럴 시 키 들	FALSE
ㅉㅉ 조용히나 있지 뭐 잘 했다고 떠느 막 나가기로 했나 부지 울 동네 보니 교회 주차장 몇 명 씩 떼 농구 시끄럽게 난리 데	FALSE
이런 미친 개독 들 너희 때문 국민 들 굶어 죽겠다  썩을 것 들  왜 온라인 예배 하 돈 안 들어 와서 엎 어 되냐  너희 한국 사회 악  그걸 이용 하는 짐 당 은 악의축 쓰레기 덜	FALSE
교회 탄압 아니라 교회 국민 들 탄압 있는 것 같다  조용히 반성 해 주변 교회 욕 하는 사람 많아졌네요	FALSE
재구 속이아니라 보석 취소 너무 모르는거 아닌가	FALSE
진짜 잡것 들 정도 지나치네  ♬ ♪♩♩♪ 고살 도 시원찮은 것 들	FALSE
국가 구한 다 고 나불대지  세수 좀 하고  양복 좀 대려 입고 다녀 광훈	FALSE
그러니 니 들  신천지 보다 못 이단 개독 것  이란다	FALSE
탄압 이러니 종교인 욕먹는거다  법 어긴것도 모자라 전염병 확산 주 범 감싸주고 싶냐 종교인 이 종교인 답 말씀 전하 당신 들 좋아하는 헌금 걷어다 누리 살 됐지 왜 정치 질	FALSE
아침 개독 때문 욕 나오게 하는군 그래서 기독교 계 방송 이사장 전두환 함께 행동 있니 종교 탄압 죄 지었으면 교도소 가야 하는게 평등 원칙 예수 욕 먹이는 개독 사라져야 한다고 생각 한다	FALSE
똥 쳐 먹어라  예수 쟁이 들아	FALSE
신천지 구속 수사 할 때 종교 탄압 애기 안 꺼내다 전광훈 구속 시키니 종교 탄압 ㅋㅋㅋㅋㅋㅋ 그럼 신천지 종교 그 당시 종교 탄압 하지 말 했어야지 앞뒤 안 맞잖아	FALSE
라이 버러지 같은 인간 들 저런 겆 들 성직자 지놈 들 눈 전 광훈 때문 고통 받는 국민 들 안보 인 말	FALSE
최종환 이 놈 목사 직업 가진 개 나부랭이 이런 놈 목사 하긴 목사 직업 너무 쉽게 따지 전광훈 이 목사 어떻게 라이센스 따는거여	FALSE
교회 사랑 없고 증오 저주 뿐 그게 교회 사기꾼 시 키 들	FALSE
개독교 사회 암세포  역병 퍼트 려 이웃 위험하게 히 국가 사회 혼란 하게 해	FALSE
니 들 성명 낸대로 해줘  그럼 입 터 것 들 바로 감빵  자유 넘치니 주체 안되지	FALSE
차라리 해외 나가서 ♩♪	TRUE
자유 개념 무엇 잘 모르는 인간 들인것 같네 모르면서 우기기까지 하고	FALSE
♪♬♩♪♪ 들	TRUE
개 목사 개줄 채워서	FALSE
이 것 들 같이 집어 넣어야되 겠네	FALSE
그래 예수 쟁이 들 생각 원래 저런거야  예루살렘 가라 제발 우리나라 안 맞아	FALSE
정부 재수감 하고 종교 탄압 하는게 아니라  우리 국민 들 반드시 재수감 하라 명령 하는거다	FALSE
너희 들 날 티비 보면서 우리 아이 들 절대로 교회 가지 말 날 얘기 있다	FALSE
교회 다니는 사람 들 정신박약아 더해 정신 이상자 들임	FALSE
니 네 한 몸 줄 알았다 이제야 정체 들어내는구나	FALSE
이자 들  함께 수감 해라	FALSE
아이고 도대체 종교 계 언제 이런 독불장군 됐나  정치 하다는 넘 들도 책임 있다  선한 목자 정치 판 이용 해 처 먹은 후 폭풍  중세시대 천주교  끝 난 무교 어이 더러운 총 알받이 들	FALSE
쓰레기 들 모였네	FALSE
진짜 종교 탄압 뭔 지 를 모르나 보군	FALSE
장로회 망령 회	FALSE
아조 가지가지 한다 생각 한쪽 쏠린지 들	FALSE
이 다 하느 림 ㅣ 뜻 아니겠니	FALSE
난 오늘 부로 기독교 떠나련 다 개독 들 더 이상 상종 안 한다 그동안 개독 들 누려 온 영화로운 삶 반성 해 전광훈 이 선지자 거짓 선지자 혹세 무민 하 사이비 사기꾼	FALSE
미친 바이러스 계엄령 넋 빠진 소리 히 고 있네 그나마 건강하게 숨쉬고 있는걸 감사해라 제발 성직자 들 공부 책좀 읽어라	FALSE
우리 교회 아니라는 장로교 교 보고있나  너희 들 대표 들 하는 헛소리  그래도 우리 목사 우리 교회 안 그렇지	FALSE
광훈  내 예수  너 날 믿는단 말  그럼 이승 하직 하 거  민폐 되지말고	FALSE
억울 하다 생각 하시는 목회자 분들  다 같이 들어 가세  기도 욜씨미 하면서 회개 히 세  천국 그대 들 것 브디 오래 왜 쭈웈 길게 이주 오래 오래 회개 하다 깨으치시고 가능 하다면 생 마김 하기 전 깨우치셨으면 바 법니  아멘	FALSE
자세히 보면  저 뒤 삐라 뿌리던 수상한 팍 상 넘도 똥개 열심히 부채질 하면서 따라다니고 있지	FALSE
정말 또 라이 들 많네 너 거 들 그리 설치는 사회 공 안정국 탄압	FALSE
니 네 사탄	FALSE
왜 종교 나라 국민 암 적 존재 되어가는지	FALSE
어느 교회 이런 막말  공개 하라	FALSE
교 계 뭔 단체	FALSE
대신 교단  대신 증권 예 하 단체  ㅋㅋ  쓰레기 들	FALSE
제 정신 나간 놈 들 전광훈 하나 뿐 아니라니까	FALSE
니 들 아버지 하나님 불쌍타	FALSE
니 들 목사	TRUE
개신교 전광훈 이 개신교 회장 되는 순간 이 땅 OUT 되었습니다	FALSE
아 진정 탄압 하고싶다	FALSE
♪♬ 들의 집단 ㅋ  종교 탄압 전광훈 이 종교 ㅋ  기 도교 사이비	FALSE
일제 독재 협조 하던 개신교 보수 교단  민주 정부 방역 지침 반발 하네	FALSE
테러 집단 뭔 개 소리 확 마	FALSE
아이고 부처님 예수님 ㅋㅋㅋㅋㅋ	TRUE
종교 이름  정치 놀음 하니까  ㄴ 당신 들 종교 이웃 너무 사랑 해서  코로나 함께 걸리고 싶은 모양	FALSE
전광훈 똑같은 것 들 널렸구  저런 목사 한 명당 딸린 그 많은 교인 들 똑같은 정신 상태 게 정말 큰 문제  교인 들 제 정신 이어야 하는데 거의 불가능  제 정인 이 저런 인간 들 목사 있는 교회 안 다니겠지  어쩌  ㅜ ㅜ	FALSE
살인자 들 공범 들	FALSE
니 들 목사  지나가는 똥강 쥐  목사	FALSE
아 이스라엘 조 상신 야훼 믿는 것 들 어쩌면 저리 뻔 뻔한가 야 이 것 들 전지전능하다던 야훼 뭐 하느라 목사 들 신도 들 병 걸리는데도 하나 구제 하지 못 하는 거 어디 한번 답변 해 봐라	FALSE
민주화 운동 하는 줄  자유 민주 × 도 남용 하는 자 들  사랑 포용 의무 책임 뒤로  종교 포장 해 사회 혼란 야기  부축 이 저 들 저 북 빨갱이 집단  쇠뇌 화 된 콩크리트 비 이 성화 된 무리 들	FALSE
교회 국민 탄압 대해 해명 하	FALSE
우리나라 기독교 전체 다 사이비 아닌가싶다  정신 제대로 아니야	FALSE
미친 것 들	FALSE
법 안되면 발포 하  국민 건강 국가 건강	FALSE
테러리스트 들 무슨 잡 소리	FALSE
개신교 싫다	FALSE
완전 또 라이 들 해봐 한번 이 사이비 들	FALSE
악 미 들 최후 발악  미친 집단 살충제 박멸 해야 함	FALSE
이 것 들 이 땅 없어졌음 좋겠다	FALSE
이런 것 들 없애고 모조리 살 처분 해	FALSE
가만히 있으시요  그렇지 않아도 기독교 반감 심한데 더 심해짐	FALSE
종교인 과세 ㄱㄱ	TRUE
종교 탄압 언제 이단 갈것처럼 말 하더니 어차피 다 들 한 통속 전광훈 무슨 신 되냐 종교 탄압 교회 박살 내고 총 칼 들이밀며 예배 못 드리게 하는게 종교 탄압 죄 있는 사람 잡아간다는데  교회 유지 되려면 대한민국 나라 법 테두리 안 합법 적 행동 해야지  불법 저지르고 목사 이유 면죄부 줄순 없지 아니 더 엄벌 처 해야지	FALSE
종교 이렇게 무서운거다  인간 이성 마비 시키지	FALSE
싹 다 갈아엎어주세요	FALSE
순 교하면 당신 들 말 하는 계엄령 항거 할 맴 쪼매	FALSE
사형 시키지 않은 것 감지덕지 해야지	FALSE
종교 계 부 크러 운줄 알 좀 자중 회계 들 하세요 세상 천지 분별 못 하나님 영광 가리는 짓 들 멈추세요 목 곧은자는 하니 님 치 신다고 핬습 다 왜 이 코로나 사태 멈추지안는지 회계 하세요 빛과 소금 역활 다 디 갓 나 오염 생산 아닌지 회계 들우 ㅏ 세요	FALSE
니 들 땜 전 국민 죽을만큼  힘든다고 제발 교회 목사 들 말좀 하지마라  예수님 정치 안 했어 이 쓰레기 들  교회 목사 빼고 나와서 정치 하던지 교회 좀 그만 욕먹 여 이 벌레 들	FALSE
니 네야 말로  종교 미명 앞 새워서  주민 이웃 탄 앞좀 하지마라  니 땜 자 영업 학생 일 반시민 모든 사람  고통 받고 있다  내 개인 적 생각  나네 모조리 섬 가두고 싶다  악 무리 들 같다	FALSE
얘넨 또 누구	FALSE
어릭 아이 들 가르 처 되 기독교 종교 얼마나 사악한 집단 인지	FALSE
대신 총회 기억 합시다	TRUE
다 잡아 넣어라	FALSE
기 뒈져 빨리 쓰레기	FALSE
테러 단체 국가 전복 단체 악질 바이러스 쓰레기	FALSE
진짜 기독교 맞는가  지옥 갈 ㄲㅓ 다 이 놈 들	FALSE
종교 탄압 말 할수 없 읍니  법 어긴 교회 잘못 시인 대국민 사과 하시기 바랍니다 교회 국민 들 근심 거리 되고 있 읍니 교회 실정법 지켜야하고 하나님 법도 지켜야 합니다	FALSE
전광훈 종교 신	FALSE
테러 종교 정부 탄압 맞는말	FALSE
별 거지 자식 들 ♪♪ ㅋㅋ 그게 탄압 위반 한 것 누구 니 그 들 좋아하는 빤스 훈 아니냐 갔다 붙이 걸 붙여라 ㅋㅋ 탄압 이 지나가는 빤스 웃것다	FALSE
싸 그리 수출	TRUE
개독 들  예수님 그리 가르쳤냐	FALSE
하느님 와 돼 먹지 않는 사회 악인 저런 짐승 같은 자 들 청소 안 합니까	FALSE
나도 교인 전광훈 저리 지지 해주는 목사 교 이해 할수 없음 교회 욕먹지 않게 제대로 생각 걸 가지시길	FALSE
손 총 안 들었을 뿐 이 들 Is 나 탈레반 뭐 다르나	FALSE
뭔 ㄱ ㅐ 소리	FALSE
한심한 인간 들 예수 너희 들 절대로 구원 안 할거다	FALSE
저런 자 식 세 끼 들두 저러고 다니나 그러겠지 배운게 도 둑 질 그 피 그 피 겠지	FALSE
나도 장로교 신자  참말  대신 총회 임원 들 제 정신  미친거 아닌가	FALSE
별 개 그지같은 단체 많구나	FALSE
온 지구인 들 코로나 힘들어하는 시국  코로나 감염 남 일 여전히 느껴진다면 이건 지구인 아니다	FALSE
개돼지  쥐소 말  바퀴벌레	FALSE
쓸어 버려라 ㅠ	FALSE
전 국민 고생 하는거 안보 쓰레기 들  학교 못 가고 애 들 땜 엄마 들 고생 하는거 안보  감염 자 줄었다가 왜 다시 늘었냐 니 들 때문 쓰레기 들	FALSE
나도 교회 장로 니 들 너무한다 바이러스 퍼뜨리 법 어기 이 단 짓 선동 하는데 뭐 종교 탄압 하나님 니 들 교회 심판 하신다	FALSE
목사 들 세금 내고 나대라	FALSE
아 저 것 들 광화문 집회 교회 신도 들  보내라고 종용 것 들 조사해  우리나라 기독교 이렇게나 광 집단 되어  있었다니 이제 종교 단체 세금 걷읍시다  신 성 시 웃기 있네	FALSE
기사 정확하게 씁시다  대 신 총회 전광훈 이 자기 교단 목사 면직 당하고 쫒 겨 다음 지가 세운 교단 잖아요  뭔 교 계 단체 전광훈 똘마니들	FALSE
전광훈 감 하는 사이비 목사 감옥 보네 이사회 격리 대상	FALSE
저 마귀 들 때문 스트레스 받아 미치겠다	FALSE
종교 아니고 다단계 회사 겠지	FALSE
저 덜 떨어진 것 들 마저 잡아넣어 버려야지  에혀  정말 법 웬수  저런 것 들 독재정 권 때 구국 기도 회하 면서 정권 딸 거리 던 놈 들	FALSE
교단 전체 어쩌다 저 모양 이 됬는지  상종 못 할 사이비 교단 낙인 찍혔다	FALSE
대신 교단 아웃	FALSE
진정한 종교인 들 조용한듯  옛말 빈 수레 시끄럽다고	FALSE
정말 넌더리 난다  왜 개독 난리	FALSE
무슨 전광훈 이 목사 교인 고 종교 탄압 그럴 때 쓰는 말 아냐	FALSE
대 신 총회 전광훈 목사 소속 된 장로회 교단 일 걸	FALSE
대신 총회 검색 하면 나옵니까	TRUE
목사 작자 들 수준 봐라 다른 나라 알까 부끄럽다	FALSE
전광훈 이 목사  파리 새다	FALSE
바이러스 못 한것 들이 교회 단체  일부 돈 미친 것 들 교회 전교 회전체 하지마라	FALSE
교인 수감 했나  정신 나간 소리	FALSE
나 총 다오	TRUE
성령님 왈 니 들 다 사이비 목사 아닌 광신도 하면서 지옥불 빠뜨려 야한다고 한다	FALSE
한국 교회 목사 신도 모두 재 평가 받아야 할 것 같다 더 이상 예수님 핑계 본인 들 이익 위 생계 집단 변질 시키지 마라 종교 자유 기본 적 자질 갖춘 뒤 한번 생각 해 봐라	FALSE
대 한 예수교 장로회 ㅡ 지금 다니시는 분 그만 다니세요 ㅡ 그런 집단 무슨 종교	FALSE
그거 아세여 ㅋㅋ  전광훈 좀 으리 으리 해보이잖아요 ㅋㅋ  근데 별거 아닙니다 ㅋㅋㅋ	FALSE
사이비 연합	FALSE
아직 목사	TRUE
너희 같은 xx 놈 들 날뛰는게 문 정권 기회  주는 걸 왜 모르니 신기할 따름  뭐 생각 없으니 날뛰겠지만 xx 들	FALSE
나도 교인 이건 아니다 사회 어지럽게 만드는자 구속 정답 입니다 하나님 이렇게 가르치지 않습니다	FALSE
정치 하는 목사 들  하느님 정치  목사 직 때려치고  정치 해라 x 자식 들  그 좋은 천국 은지 들  안 가고 우매 한 신도 들  보낼려고 하는 저 의 뭐	FALSE
뭐라고  멍멍 짓어서 뭐라는지 모르겟는데	FALSE
이런 걸 주술 하는거다 기사 써라 기사	FALSE
역시 기독교 어쩔 수 없군	FALSE
대통령 구속 죄 고의 방역 막말 해도 가만히 두는데 그게 독재  남영동 다시 끌려가는 세상 만들고 싶나	FALSE
신도 등 쳐서 먹고사 넘 들이 머 잘났다고 니 네 들 사회 악	FALSE
너희 같은 기독교인 너 이웃 국민 탄압 하고 있다는 것 모르나  개독교 인 불리 마라	FALSE
예 장 대신 수준 그렇지 뭐  기독교 따따블 망신 시키는군	FALSE
이런게 목사 우러러 받 드냐  그럼 전 국민 들  하느님	FALSE
야 전광훈 야광훈 야 훈 들어가있어	FALSE
예수 쟁이 들은 다 똑같다 신앙심 개뿔 그냥 돈벌이 수 단일 뿐	FALSE
교회 가장 국가 테러범 들 종교 가장 해 남 목숨 가벼이 여기 질서 무너 뜨 리 위태롭 하는 집단	FALSE
테러 자 탄압 해도 된다	FALSE
저 것 들 지 정신 아닌 넘 들이다  정신병원 넣어라	FALSE
사이비 들 확실히 종교 포장 해서 밥 벌이하는군	FALSE
저 새끼 들 티케 이 주류	FALSE
니 들 무소 불위 무슨 중세시대 상상 사니	FALSE
정말 ㅆㄹ 기네  하 나니이 그렇게 말 한적 있냐  똥통 들	FALSE
대 한 예수교 장로회 ㅇㅇ 총회 어마어마하게 많다  대 한 예수교 에다가 갖다 붙이 될 정도  ex 대 한 예수교 삽질 총회         대 한 예수교 빤 쓰 총회         대 한 예수교 콩가루 총회         대 한 예수교 나라 말아먹기 총회 ㅠ ㅠ	FALSE
저런 위대한 분 들 말  현혹 된 수많은 신도 들  안타깝다	FALSE