말 잘 들으라는 거 겠지	TRUE
종교 자유 탄압 할 공산당 무리 무슨 기독교 불교 가시 알 방구 위선 적 것	FALSE
머 저리 들 뽑은 닭 대가리 대통령 싼 똥 치우느라 문 대통령 엄청 고생 하시는데 뭔 소리	FALSE
문죄인 구속 하면 국민 통합 저절로 된다 정세균 문죄인 바지 총리 하려고 욕먹어가면서 하는 꼴 우습지 않나	FALSE
정세균 무승 꿍꿍 이 국무총리 민주당 항상 의심스럽다	FALSE
정말 싫다 자질 안되면서 나대 기만 소통 뭔 지 모르는듯	FALSE
좋습니다 정 총리 님 지금 국론 분열 되고 여론 분열 되고 있습니다 초심 잃지 마시고 국가 국민 위해 국론 분열 되지 않고 이나라 평화 길 갈수 있도록 최선 다해 주십시요	TRUE
아래 수 수	TRUE
애 수 수	TRUE
기독교 빼죠 자꾸 권력 맛 돈맛 보 썩잖아요 기독교 그냥 기독교 되게 놔두세요 누가 한숨 더불어 넣으면 터지는 풍선 같아요	FALSE
기독교 교회 협의 회 제대로 성경 보시 거기 가서 머리 조아리라 했는지 아닌 걸 아니라고 했는지 목사 사명 직업 구분 못 하는 삯군 들	FALSE
요즘 재인 양산 족 히 수나 족 히 되는 어마어마한 양돈 농장 채렸다메 국민 개돼지 취급 하니 그런 소리 들을 만하	FALSE
이 자식 웃기 맥 잘 짚어야지 국민 통합 문어벙 문희상 이해찬 문제 너 문제 좌빨 문 빠 들 문제	FALSE
더 이상 이런 억울한 분 발생 되질 않기를 간절히 소망 합니다 잃어버린 을 누가 보상 해 줄 수 있을까요	TRUE
저런 독재정치 정통 성 잇고 있는 친일 자유 한국 당 없애야 한다 자신 진정한 보수 라면 친일 독재 폭력 원흉 들 과 감히 처단 당당해져야 한다 물론 그 들 돈줄 대고 있으니 힘들겠지만 ㅋ 전두환 은닉 재산 다 어디 있겠어 자유 친일 한국 당 금고 있어서 수사 못 하잖아 ㅋ	FALSE
이런 독재 행위 드러나도 틀 딱 들은 맥노 독재자 일당 지지 다 단순히 세뇌 돼서 가 아니라 인성 자체 싸이코 패스 그럴까	FALSE
고문 부당하게 진술 케 했으니 당연히 무죄 맞죠 상식 적 그 책 들 북괴 이롭게 할 목적 책 들	FALSE
지금 그때 그 시절 공 안검 사들이 정치권 활개 있다	FALSE
지금 자 한 당 소속 국 개 의원	FALSE
세상 정의 사회 바뀌었음 보여 주는 지표 중 하나 또 하나 임은정 나왔다	FALSE
이 보수 우익 정권 이었다 북한 인권 말학 전 우리 인권 탄압 대한 반성 해야하지 않나	FALSE
자 한당 전신 이렇게 정권 이어 왔으니 맹박 특히 닭 보고 배운게 이런거니 정권 잡고 국민 들 기 망하며 권력 휘둘렀으니 나라 제대로 돌아가겠냐 지금 우파 하는 자 한당 하는 꼬 지도 똑같지요 자 한당 저 들 절대로 정권 잡으면 안됩니다 또 똑같은 일 들 자기 들 기득권 위해 머 할 겁니다	FALSE
검찰 개혁 해야 한다 그때 검찰 지금 검찰 달라진게 무엇 아 하나 있네 무죄 구형 것	FALSE
국가 보상 해야 한다고 봅니다 고문 자행 수 사관 검찰 판사 들 처벌 필요합니다	FALSE
검찰 잘 보아라 이 너희 들 민낯 과거 특권 내려 놓아라 국민 명령	FALSE
이런 말 안되는 사건 들 횡횡 시대 고생 하신 분 들 피값 어린 희생 때문 현재 있 음 또 깨닫습니다 이 값진 피값 잊지 않기를 기 도합 니 제대로 된 구형 이제 해주신 검찰 부 감사 드립니다	TRUE
황교안 등 박죙희 후예 들 모두 자살 하기를	FALSE
보수 꼴통 정권 개 노릇 하던 개 조폭 검찰 그래도 무식한 전두환 일본군 장교 다 까 끼마 사오 박정희 찬양 하는 무식한 보수 꼴통 틀 딱 들	FALSE
이런 만행 자행 했는데도 뻔 뻔하게 그때 기장 쿨했다고 씨부리는 작자 들 반성 회개 하는건 커녕 그때 그 시절 그리워하며 자식 들 장한 이 버 인척 부모님 장한 아들 이척 위선 된 삶 살다가는 거지	FALSE
무고 백성 죄 뒤집어 씌워 억울하게 죽 고문 옥살이 하게한 독재주의 자 한당 지구 사라져야 한다	FALSE
저런 고문 경찰 조작 검사 들 지금 연금 따 박 따 박 받고 있겠지	FALSE
전두환 시킨 짓	FALSE
쓰레기 검사 놈 들 일 제때 독립운동가 들 하던 짓 고대로 하고 있구만	FALSE
당시 나를 재판 했던 탁재업 한호 형 황 수 길 어디서 잘 살 있나 모르겠어 누군가 그 들 알 있겠지	FALSE
광화문 폭력 집회 하 틀 딱 들 잡아다 반죽 때 고문 해서 “ 아베 지시 진보 정권 약화 시키려 시위 벌이 천 황폐 하 찬양 했다 ” 는 진술 받아 낸다음 후 혹시 살 있으면 그냥 무죄 처리 해주면 됨	FALSE
개검 들 진짜 다 죽 이 고 싶다	FALSE
죄 있면 달개 받아야지	FALSE
천벌 받을 인간 들 참 많네	FALSE
당시 검찰 떠들었고 언론 이를 증폭 했고 합리화 정당화 의미 부여 했고 한 개인 인권 말살 되었다 검찰 이런 허위 정보 생산 돋재 권력 구조 공고 히 해주는 댓 가로 권력 돈 나누어 가졌다 우리 조국 전 장관 사례 이서 다시 데자뷰 느낀다	FALSE
독재정 권 자유 한국 당 표본 이 뵤 보수 떠들면서 조중동 다 같은 무리 들	FALSE
쪽팔리는줄 모르네 주사파 시 바리	FALSE
개 XX 야 주택 거래 허 가제 금강산관광 재개 등 김정은 수령 지령 충실히 이행 있으면서 사기 다니지 마라 총선 패배 확실하니 총 선전 북괴 흡수 통일 당할 공작 펼치고 있는 것 아니냐	FALSE
세균 거 기사 사라지거라 국민 들 세균 오염 시키지말고 머 저리	FALSE
그럴 시간 있으면 달동네 엄동 설한 떨고 있는 어르신 들 위로 결식 노인 아동 빵 우유 제공 하라 추신 총선 다가오니 종교 계 눈 도장 찍고 표 구걸 하러 간것 안보 인	FALSE
이낙연 검찰총장 징계 관련 지시 따르지 말 추 법무 지시 하	FALSE
하나님 앞 가지 못 할 사람 들	FALSE
새 균 씨 축의금도 관행	FALSE
비굴한 선거운동 ㅋㅋㅋㅋㅋㅋ	FALSE
이 나라 종교 종교 같지가 않네 정치 세력 같이 행동 하네 그러니 정치 꾼 들이 개 소나 가서 개 소리 하지	FALSE
이 나라 완전히 거 덜내고 있는 종북좌파 들 돕겠다니 이 거 땡 중 아닌가	FALSE
선거 전 딱히 보기 좋은 모습 아니다 민심 완전히 민주당 등 돌리려 한다	FALSE
종교 계 빨간 놈 들 장악 했어 국민 언 데 간데 없고 지 들 사상 강요 하는 놈 들 이 공산주의 뭐 별거 있냐	FALSE
조계종 좌파 였어 국가 미래 생각 해야지 ㅉㅉㅉ	FALSE
중이 정치계 기웃 거리 부처 욕먹는다 뭐 여당 지지 권력 편승 하여 아부 하는 타락한 종교 집단 역겹다	FALSE
ㅋㅋㅋ 불교 타락한지 꽤 됐지 특히 조계종	FALSE
종교인 면서 국민 정부 택하 힘 눈 멀 엇네	FALSE
불교 개 쓰레기 집단 여당 정부 도 울거라고 약속 했다는 말 이제 종교 정부 밑 닦아주는 같은 쓰레기 되어주겠다고 약속 했다는 소리 정말 개탄 쓰럽다 이나라	FALSE
이중성 보이니 땡 중 야채 머꼬 저렇게 돼지 될수 있는지 참	FALSE
이건 또 무슨 헛소리 중생 위해 일해	FALSE
이분 제 정신 아니네 지금 얼마나 국민 핍박하고 괴롭히는데 돕긴 뭘 도 그렇게 한쪽 편 드는건 좀 문제 있다고 생각 하지 않냐	FALSE
불교 신자 불교 타락했네 이제 시 주 끝	FALSE
중놈 선거 판 죄 우 하 것 종교인 중립 지켜야지	FALSE
종교 정치 관여 하지마라	FALSE
중세기 들 진짜 역겹네	FALSE
종교 정치 이용 하려는 이해찬 좌빨 물든 불교 땡 중이 국가 먼저 생각 해주기 바란다	FALSE
때 중이 왜 속세 관여 하 먄 빨갱이 짓 북한 돈 퍼주는 부처님 뜯이냐 북한 중생 들 위 것 아니라 북 돼지 돈 주는게 하긴 중이 몇 억 짜리 외제차 몰고 북 갔다가 자식 남겨 두고 온 놈 들 있으니 할말 다 했지	FALSE
이번 육포 사건 빨갱이 들 꾸민 짓 같다 황교안 이 미치지 않고 서야 육포 절 선물 보내냐 육포 사건 있고나서 바로 독사 같은 이해찬 이 저렇게 조계종 찾아가는거 봐라 뭔가 가려진 사건 내막 있는게 분명하다 경찰 조사 넘길 일이	FALSE
진정 종교인 라면 이 시국 권력 맞서 할 얘기 들 똑바로 해야지 그냥 정부 여당 빌붙어 먹겠다 ㅉㅉㅉ 한심하다	FALSE
거기 서는 막말 안 하셨나 막말 하고 싶어서 어떻게 참고 사냐	FALSE
스님 들 빨갱이 지지 하 안되지 그러면 땡 중 소리 듣지	FALSE
오오 미 조계종 빨갱이 소리 듣것네 ㅋㅋㅋㅋㅋㅋ 왜 들 이러냐 정말	FALSE
종교 적 탄핵 없나 어떻게 이런 발언 할 수 있나 선 문답 아니고 직설 적 종교 독재 하나	FALSE
이 거 완전 똘 ㄸ 덩어리 주지 육 림 꽃길 가시겠다	FALSE
스님 이해찬 장애인 관련 막말 꾸짖으셨나요	FALSE
저 땡 중 하나 불교 계 망친다 불교 신자 들 저 조계종 땡 중 제거 하세 요지 원 데 이해찬 저 거 이 함로 말 하 싸가지 없는 놈 들 지 지 한다는 저 땡 중 조계종 말아먹는디 ㅡ	FALSE
누가 저런 정치 기생 중 들 뒤좀 파보 자 더르븐 ㅅㅅㅣㅂ 중 들	FALSE
불교 정치 속 세 일 관여 하지 않는 것 옳다 하겠으나 현실 환경 그렇게 한가롭고 여유롭지 않으니 안타깝 도 세계 적 관점 보았을 때 현재 한국 불교 처지는 중국 아시아 국가 들 화해 평화 번영 발전 막고 차단 하기 위해 미국 우선 기독 우월 주의 입각 쓰레기 미친 친일 앞잡이 세력 들 도발 문화 전쟁 한가운데 놓여 있다 하겠다 한국 불교 뿐 아니라 아시아 및 전 세계 불교인 들 국제 정세 상황 엄중한 시점 임 알 종파 국가 넘어 긴밀히 소통 협력 하여 이 문화 전쟁 위기 지혜롭 잘 넘어가야 할 것	FALSE
왜 이럼 불교 계 정신차려	FALSE
쓸데없는 짖 하지마	FALSE
스님 추녀 삼보 일배 하셔야겠다	FALSE
제발 부탁 종교 종교 본연 일 잘 해라 그리고 정치인 들 종교 이용 하려고 하지말고 점점 갈수록 이 나라 이슬람 극 단 주의 국가 같아 보인다 정치 적 발언 하는 종교인 들 그걸 이용 해 먹겠다고 달려드는 정치 본질 봐라 정치인 일 잘 하면 종교 안 만나고 다녀도 다 뽑아 준다	FALSE
정말 역겹네 뒤 룩 뒤 룩 쌀진 돼지 땡 중 보고 있자니 거기 옆 해골 바가지 원효대사 통탄 하겠다	FALSE
기독교 불교 싸움	FALSE
땡 중 ㄲㅈ	FALSE
산 산이 물 물이	TRUE
찾아가는것도 웃기 스님 정치 하나요 자기 본연 일 충실히 할 때 나라 바로 섭니다	FALSE
요 땡 중 놈 항상 정치 적 힘 센 놈 빌붙어서 시주 얻어 처 먹고 사는 양 아치 개차반 같은 놈	FALSE
이해 차니 아직 나이 어린 놈 행동 상노인 모습 ㅈㅈㅈㅈㅈ	FALSE
중립 지켜라 종교인 답 ㅡㅡ 땡 중	FALSE
땡 중 권력 와 손잡고 ‥ 암자 들어가서 수도 해도 모자랄 판	FALSE
원효대사 해골 물 먹어서 유명했는데 저 해골 왜 저러냐	FALSE
한국 불교 정치 관여 하면 않 된다 조계종 총무 원장 원 행 이 빨갱이 란 말	FALSE
스님 무슨 정치 하시나요 나도 불 자 이 개 망나니 같은 문 재앙 공산주의 독재자 아니지요 불자 들 들고 일어나기 전 정신 차리시오 혹시 이 것 기레기 편집 가짜 뉴스	FALSE
이건 또 뭔 땡 중	FALSE
목사 중이 정신 좀 차리시오 보살 아멘 닥치거라 큰 중	FALSE
그거 개인 적 생각 전체 적 생각 아니라고 본다 이해찬 골 박아 얼마나 급한지 종교 계 꼬득 자기 편 만들려고 저 짓 하냐	FALSE
종교 정치 떠나야하는데 특정 정파 지지 하니 신도 들 불교 비난 불교 배척 할 것	FALSE
그래도 베네딕토 세는 사임 후 영향력 미치려 하지 않고 은둔 자 삶 살았는데 호칭 복식 정도 이해 해줄 만하 않나	FALSE
이 새 낀 성직 잔 머 하는 작자 모르겟다 지난번 성질 내는것 보면 아주 막산 새끼 같은데 교양 몸 볼수가 없어 손 흔들고 헤헤 웃 때 보여주니 몰랏던거	FALSE
금강산 개성 마식령 스키장 ㅡ 다 가고 싶음	TRUE
대웅전 앞 소금 뿌려라 재수 엄따	FALSE
이리 기웃 저리 기웃 하면서 나 퍼스트레이디 하는 걸 즐기는 천박한 여자 일 뿐 대선 전 낸 책 제목 어쩌면 퍼스트레이디 저 한복 국민 세금 고혈 쥐어 짜서 또 새로 특별히 맞춘 옷 겠지 돼지 목 진주 목걸이	FALSE
ㅋㅋㅋㅋㅋㅋㅋㅋ	TRUE
쑈 영혼 팔 먹어야 한다	FALSE
표 때문 뭘 길게 설명 하냐 총선 다가온다	FALSE
쇼 하는것 배웠냐	FALSE
치매 걸렸으니 돌은거지 ㅋ	FALSE
종교 정치 적 이용 하는 인간	FALSE
개념 없는것 들	FALSE
가긴 왜 갔겠어 ㅋㅋㅋㅋ 주책 떨러 간 거지 ㅋㅋㅋㅋ	FALSE
천주교 상관없어요 절 가도 여기 저기 다 좋은	TRUE
절밥 맛있다는 소문 들어서 ㅋㅋ	FALSE
선풍기 아줌마	TRUE
아 휴 깜짝	FALSE
신랑 정신차리도록 내조 좀 확실히 하도록	FALSE
쳐 박혀있어라	FALSE
참 더럽게 설쳐 대네	FALSE
이마 보톡스 필러 좀 그만 맞아라 너무 빵빵 살이 정말 찌 찌	FALSE
스님 표정 어쩔 ㅎㅎㅎ	FALSE
쇼 좋아하는 가증 덩어리	FALSE
박정희 교 신도 들 큰 애 똥파리 빠는 구더기 떼 들은 박 큰 애 핥는 일 아님 발광 지진 태풍 장마 덮어질 집단	FALSE
부끄럽다 북괴 우상 화한다고 김정숙 시도 만드는데 우리 못 하냐 김정숙 시 지명 된 도시 하나 없고 김일성 김대중 같은 동상 없고 광주 김대중 컨벤션 센터 같은것도 없고 부끄럽다 꼭 북괴 금강산 어록 북한 산 바위 새겨놓고 우 덜 식 민주주의 하는 문 재앙 나라 빨리 되라 문샬 이니 후 아르 바크	FALSE
기독교 달 리 천주교 모든 종교 수용 다 기레기 기본 ㄷ 모르고 여론 호도 해서 편 가르기 하냐 ㅉㅉ	FALSE
쇼 좋다 닭뇬 이런 쇼 안했드 그 시간 뭐 했으까 나 그것 알고시 푸다 ㅋ	FALSE
인권위 서민 약자 소외 계층 인권 보호 하 곳 아닌가 누가 봐도 최고 실세 권력 조구이 아닌가 조 구 기 아들 딸땜시 피 눈물 흘렸을 그 청년 들 인권 챙겨라 썩을	FALSE
조 국기 마음 빚 지고 뭐 미안한 감정 이 게뭘 내포 하 하면 모든 지시 재앙 가했거나 같이 저질렀는데 조국 기만 수사 당 책임져 야하니 미안하다는거지 애초 재앙 이 몸통 국민 검찰 알고있어 최대한 예의 갖춰서 재앙 이 스스로 내려기 올 기회 주었는데 오히려 수 사 기관 겁 박하고 수 사 처 폐지 해 버리는 법치 파괴 저지른거지 이제 남은것은 파면 탄핵 저지를 른죄 그걸 감추려고 공 수 처 수사권 조정 검찰 파면 인사 법치 파괴 한 죄 더 클것이다	FALSE
선동 적당히 해야지 ㅋㅋㅋ 상장 사기 친거랑 국가 자금 빼 돌린거랑 같냐 허수아비 년 비교 하네 틀 딱 새 키	FALSE
정확한 비 선의 윗 선 문죄인	FALSE
spa 토착 빨갱이 인 가보네	FALSE
비 선실세 김정 수기 ㅋㅋ 말춤 년 노리 족국 ㅎㅎ 콩가루	FALSE
청와대 인권위 좌빨 주사파 들 다 차지 지 들 끼리 짜고치는 고스톱 판 국민 들 우롱 하고있지 개돼지 들 이 뭣 모르고 거기 따르고있 기도 하고	FALSE
부탁 올림 개 돼지 비유 하지 말아주시길 간곡히 요청 드림 개 돼지 깨끗한 동물 인간 무한 모든 걸 제공 하는 고맙고 사랑스런 존재 들 입니다 인간 더 더러운 동물 없시요 문 대갈 보세요 추악한 행태 여과 없이 내 뿜 으 면서 낄낄대는 저 흉물 면상 또한 그 졸개 패거리 일당 들 놀음 잊으시면 안되요 퇴임후 반드시 모조리 처헝 해야 합니다 온정 따위 금물 이	FALSE
특히 개 줌마 개 저 씨 씹 빛챵 너 단 들	FALSE
그 때 국민 위 정치 했다 콩 고물 먹으려던 야 들이 있었던거지	FALSE
더블 백 민주당 문죄인 정권 조국 끝 막으려는 이유 이미 청와대 마약 성폭행 탈세 미성년 자 출입 등 버닝썬 마피아 버금 가는 조직 적 최악 울산 시청 선거 온갖 수단 방법 안 가리고 권력 휘둘러 당선 시켜서 이제 박근혜 깜빵 갈수 없으니까 독제 적 지랄 발광하는거다 이제 국민 문죄인 너 처단 한다	FALSE
나 다 떠나서 대한민국 사람 라면 조국 일가 얼마나 범죄 많이 지었는지 다 아는데 처벌 못 할 망정 청와대 왜 그 보호 해주려고 하는지 참 너무 썩었다	FALSE
원래 자기 한 말 지킨 적 없었음	FALSE
맞네요 빵터졌네요 ㅋ 한번 경험 해보지못한 나라 계속 살 야할까봐 뭐라도 밝혀졌음 바램 입니다	FALSE
조국 무슨 인권 침해 당했다는 건지 이해 안된다 대한민국 국민 죄 짓고도 모두 조국 대우 받으면 누구 불평 하지 않겠다 청와대 폐기 요청 공문 모두 공개 하라 국민 알 권리 있다 또 무엇 감추려 하나	FALSE
민주 적 절차 뽑아 놨더 나머지 눈길 조차 안 주고 봉건시대 왕 노릇 하는구나 실상 이러하니 밑 것 들 다 한자리 차지 또 차지 하려고 딸 랑딸랑 예스 외치 이 법치 자유 민주주의 국가 니 들 말 한 대로 이 나라	FALSE
대통령 작자 헌법 수호 의지 도 없어 보이는데	FALSE
저건 진짜 팩트 임 ㅋㅋㅋㅋㅋㅋㅋㅋ 진짜 사회주의 믿는 세 키 들 하나같이 한소리 우리 한번 떵떵 거리 살아야지 하는 소리 많이 했음	FALSE
청와대 이 젠 아예 사리 분별 없어진듯 하다 너무 아마추어 말 안 나옴 공문 담당자 혼자 보내는 것 아니고 결재 라인 있다 청와대 최종 결재 자 수석 대통령 될수 있다	FALSE
ㅋㅋ 국격 보여준다 국가 최고 기관 공문 착오 보냈다고 발뺌 ㅋㅋ 니 들 어공 졸 공이 그냥 꺼 지시	FALSE
청와대 아니라 완존 시정 잡배 집단	FALSE
인권 침해 오히려 각종 특혜 받지 않았나요 본인 혐의 언론 알려지는게 두려워 급하게 피 사실 공표 금지 인해 다른 어떤 분 들 여론 뭇 매 덜 받았고 공개 소환 금지 지하 주차장 기자 피해 소환 받았으며 그 부인 아프다며 뚝 하면 소환조사 중 조퇴 일 삼았습니다 관연 이런 특혜 일반인 이었다면 가능할까 요 그리고 심야시간 조사 이분 안 했죠 오히려 특별대우 받았는데 인권 침해 라면 기존 전과자 및 교도소 계 신분 들 다 인권 침해 입니다	FALSE
또한 자택 압수수색 시 변호인 올 때 기다렸다가 실시 하는게 다른 일반 시민 가당 키 한 일일 까요	FALSE
그리고 아직 핸드폰 압수수색 안되었습니다	FALSE
독재자 문재인	FALSE
정말 개 같은 나라 개 같은 청와대 세이 들 이 게 나라	FALSE
대통령 마음 빚 있으니까 우리 이해 해야죠 청왜 대 민주당 조국 범죄 때문 상처 받은 국민 분열 고통 받은 국민 들 마음 빚 전혀 없는 거	FALSE
문 재앙 더불어 공산당 진짜 작작해라 니 들 감옥 아니라 사형 밥값 아깝다	FALSE
조국 윤 총경 양현석 승리 그 위 문 대가리	FALSE
조국 구 하려고 별 생쇼 하고 지랄 들 능력 도 없는 것 들	FALSE
참으로 가지가지 합니다 한 나라 수장 일개 조국 빠져서 청와대 통 욕먹고 있네요 이참 확실히 파헤쳐서 조국 정부 잘 못 한게 있으면 온 국민 들 알 해야죠	FALSE
청와대 온갖 권력 행사 하면서도 약자 척 하는 그 이중성 혐오 스럽네요 조국 인권 신경 쓰는것의 사회 적 약자 신경 써야 하지 않나요 조국 정말 사회 적 약자 대통령 사회 적 약자 하겠네	FALSE
어쩌다 대통령 문재인 정부 진실게임 정부 뭔가 일 벌리다 여론 악화 되면 실수 다라 말 진실게임 공 방 몰고가네 아니 실수 다정 부가 좋겠다 청와대 사람 들 나오는대로 씨부리다 여론 안좋아지면 개인 생각 하고 또 어물쩍 넘어가네 아물 쩍 정부 어울리는 말	FALSE
이 정도 타락한 비리 정권 공 수 처 수사권 조 정도 본인 들 비리 덮기 위해 한 것 봐도 무방 하겠군 탄핵 답	FALSE
예전 최 순 실 참 나쁘다 생각 했는데 이 젠 최 순 실 나빴나 하는 생각 들 정도 조국 이 한 일 들 보면 최 순 실 별다를게 없는 것 같은데 비 선실세 물러 내 자고 촛불 들 탄핵 시켰는데 구관 명관 이었나 하는 생각 그 현실 참 인권위 하는 일이 무언가 인권 대해 소외 된 계층 보호 그런 곳 왜 현 정권 비 선실세의 권력자 인권 챙겨야 하는지 모르겠다 통계청장 바꿔서 취업률 올리고 검찰 수 내부 다 바꿔서 청와대 수사 중단 시키고 이 젠 인권 위원장 나가리 되겠구나 이러니 이 젠 문제 주위 인재 없지	FALSE
하명 조사 요청 했다 인권위 까인게 팩트	FALSE
거짓말 거짓말 막으니까 이런 일이 생기지 ㅋㅋㅋㅋ 대통령 하나 바꼇는데 진짜 나라 아주 질 급격하게 떨어지네 총선 때 보자	FALSE
눈가 리 아웅 하는 이 정권 가증 거짓 들 날이가면 갈수록 도를 넘어선다 적폐 들 우 글 거리 청 기와집 과 위성 세력 들 난 무당파 이번 적폐 들 몰아내는데 미력 보탤까한다	FALSE
자유 한국 당 ♥♥♥♥♥ 대한민국 대한민국 정통 성 위 하 정진 하는 자유 한국 당 ♥♥♥♥♥ 지지 다	TRUE
문재인 하야 답 오래 지켜봤지만 이제 국가 위해 아니다	FALSE
국민 들 모든 분란 발단 문 통과 청와대	FALSE
온갖 혜택 다 받으면서 인권 침해 몰고가고 조국 위 나라였든 가 도대체 문 빠는 국민 들 안중 없고 오로지 지 편 북한 보이는 군 대한민국 어디 가고 있는가	FALSE
문재인 정부 국정 논단 박근혜정부 빰치 수준	FALSE
문 조 도 찐 개 찐 끈끈 ㄱ ㅇ ㅇ ㅊ 관계 구 본다 뭐 저런 것 들 한나라 장 이구 오른 팔이	FALSE
똥 싸놓고 뭉개 안쌋다 우긴다 이 진동 하는 냄새 어쩔 건데	FALSE
청와대 치매 걸린것 같아요 인권위 같은 공문 두 번 보내고 시간 따라 궤변 바뀌고 반 풍수 집 구석 망하게 하 듯이 능력 안되는게 방 구석 눌러 앉아 방도 안 빼고 애먼 국민 힘들게 하고 있어요 이 놈 들 국가 경영 운동선수 처럼 연습 하며 해도 되는줄 알고있나 봐요 국민 들 총선 현명하게 잘 하겠지요	FALSE
사기꾼 양성 소 청와대 막 파 양성 소 청와대	FALSE
역대 최악 간첩 대통령 그 새끼 조국	FALSE
너무 추하고 우스워서 지켜보기가 힘드네	FALSE
조국 청와대 사기꾼 뭉친 집단	FALSE
조국 좀 법대 처리 하자 무소 불위 권력	FALSE
코미디 인줄 알았는데 그냥 우기 기네	FALSE
지금 정부 하 짓 늘 그런것 새삼 않다 ㆍ 내 로남불 ㆍ 위선 적 공평 평등 ㆍ 위선 적 민주 ㆍ 입 벙긋 하면 거짓말	FALSE
청와대 일 하는 사람 들 요즘 왜 이렇게 나대는지 뭘 그리 보여주고 싶은지 부동산 문제 아무 꺼 툭툭 내뱉고 개인 발언 하고 장난 하나 지금 청와대 너 내 개인 발언 왜 하노 나도 진보 청와대 근무 하는 사람 들 제발 자중 성과 답 하 어이 그 쯧쯧 쯧	FALSE
국민 위 청와대 아니라 조국 범법 자 구 하기 위 청와대 우리 국민 기댈 곳 민주주의 국민 검찰 들 이나라 수장 국민 들 내 팽 개 범법 자 조국 옹호 있다는 사실 개탄 스럽고 이나라 수치	FALSE
구라 적 화대 그렇게 떳떳하다면 문서 공개 하라 나라 최대 공식 기관 맞냐 실수 잘못 보내고 실수 고민정 대변인 울산 선거 캠프 그냥 캠프 변명 하고 실수 아니고 고 의적 거지	FALSE
진실게임 같은 소리 하고있네 맘 빚 있다고 했잖아 ㅏㅏㅏ	FALSE
인권위 이 사건 발 담그는 순간 더 이상 존재 가치 필요없는 정치 집단 스스로 전락 한다는 사실 간과 하지 말기	FALSE
문재인 정부 정책 기조 조국 조국 의한 조국 위 나라인것 같다	FALSE
청와대 거짓말 하는거지 공 문 발송 대장 이미 잘 송 기록 남아있는데 또 중복 해보 낸거라는 청와대 말 믿는 놈 바보 청와대 그간 거짓말 한 두 번했냐	FALSE
범죄자 쉴드치는 정권 처음 봤다 좌파 독재 국가 맞네 맞아 공 수 처 시행 되면 와 몸서리 처진다	FALSE
일 좀 똑바로 해라 청와대 일 하는 애 들 일반 사 기업 직원 들 못 수준	FALSE
한번 경험 해보지 못 세상	FALSE
청와대 구속 들어가고 국회의원 토낄려는 것 들 잡아넣어라	FALSE
문 통과 졸개 들 제 정신 깜 안되는 것 들 앉아 있으니 능력 안되면 내려와라	FALSE
이쯤 되면 재앙 이 놈 설령 니놈 인간 탈 쓴 짐승 일지 부끄러움 알아야 한다 온 국민 아니 좌 좀비 들 빼고 니놈 비열함에 치를 떨면서 총선 기다리고 있다 오늘 니놈 지지율 조작 조작 미터 발표 했는데도 폭삭 내려 안잖더라 이딴 식 계속 나가면 조만간 끝 나겠네 니놈 탄핵 코앞	FALSE
조국 끝 감싸는 이유 가모 적폐 대상 담 정권 시 처참히 밟아 야한다	FALSE
밟으면 아니되 요 처형 답 이 그 졸개 들 일꾼 들 남김없이 수령 놈 보위부 법 공개 사살 답	FALSE
청와대 쓰레기 가득 찼다 위 아래 오물 덩어리 구나	FALSE
눈치 불리하면 아니다 한두 번 이냐 지 들 범법 자 인권 전 정권 니 덜 인권 보호 했냐	FALSE
진실게임 언제 죄 앙이 적 대가 진실 한적 있었 남	FALSE
무능 그 자체 문 넘 때문 나라 개판 오 분전	FALSE
역겨운 개슈레기들 피해자 코스프레 조국 일가 피해자 아니라 가해자 다만 피해자 들 숨어있을 뿐 저 것 들 입시 범죄 땜시 낙방 고대 서울대 환경 대학원 부산 대 의전 원 응시 생 들 권리 보호 하기 위해 청와대 권력 행사 하는게 상식 이자 정상 일진 데 진영 논리 내 로남불 DNA 각인 된 저 개슈레기들 오히려 거꾸로 보통 시민 인권 유린 사악한 범죄자 비호 하는데 그 권력 악용 한다 피해자 들 나타나지 않는 현 상황 적극 활용 하는거다 피해자 들 직접 피해 구제 요구 하지 않는한 저 개슈레기들 결코 변치 않을거다	FALSE
윤석열 총장 대 의혹 수 사 팀 해체 하지 말라 참여 인원 명 현재	FALSE
쯧쯧 하는 짓 동네 계모임 저러지는 않겠다	FALSE
도대체 청와대 누굴 위해 존재 하는가	FALSE
인권 인권 논 할 자격 없는 쥐쌔끼 패거리 들 범죄자 인권 그렇게 중 하더냐	FALSE
최고 가짜 뉴스 발원 청와대	FALSE
눈치 없이 문재인 미안하다고 공식 발표 하 좋다고 페북 질 바로 해서 논란 키우는 조국 끝 더불당 정권 폭망 힘써주길 바란다 조국	FALSE
다음 정권 문씨 싼 똥 푸느라 내내 퍼 모자랄듯 ᆢ	FALSE
이 놈 정권 갈수록 점 입가 경 쇼 하고 자빠진것 들 대가리 든게 없으니	FALSE
청와대 주민 센터 수준	FALSE
지긋지긋한 더불어 터질당	FALSE
국민 들 안중 없이 조국 미안한 문 재앙	FALSE
청왜 대 ᆢ 이런 청와대 본 적도 들은 적도 없다 대통령 자질 안되다 보니 여러가지 대한민국 이례 듣도 보도못 한일 청와대 가하고있네 ᆢ 국정 농단	FALSE
실수 무슨 역풍 맞으면 다 실수 둘러치는 아주 질 나쁜 수법 여론 좋은 것 같으면 막 밀고 나가기 ㅋㅋㅋ 여론 눈치 그러다 두 눈 다 한 쪽 돌아가 가자미 눈 된다	FALSE
이 정부 하는거 보면 그냥 무정부상태 나을 듯	FALSE
직원 개인 맘대로 직인 찍어서 공문 보내냐고 한두 명 확인 아니고 라인 따라 보고 확인 결재 다 받고 공문 보내잖아 뭔 개인 실수 넘기려고	FALSE
적 화대 믿는 국민 이제 없다 문 재앙 믿는 국민 어디 있나	FALSE
논란 지랄 공문 하나 제대로 발송 못 착오 공문 발송 하는 얼빠진 종북 좌파 주 구들 청와대 똬리 틀 앉아서 하는 일 정치 공작 종북 좌파 들 당선 시키고 검찰 무력 화 시켜 종북 좌파 들 수사 방해 원자폭탄 쌓아놓은 김정은 꼼수 써서 달러 상납 방안 연구 하는 것 뿐 이러니 나라 꼴 제대로 돌아가겠는가 경제 외교 안보 집값 어느 것 하나 안 망하는게 없다 문재인 임기 말 나라 완전히 망하지 않을까 걱정 태산	FALSE
우짜 다가 대한민국 푸른기 외집 범법 자 죄인 감싸는 상황 왔나 이전 정권 검찰 기소 간 직원 감싼 적은 없다 싸 그리 태평양 쓸어 넣고 싶다	FALSE
태평양 바다 오염 됩니다	FALSE
간 가 수틀 리 실수 게 한두 번	FALSE
강남 캐비어 좌파 만 낯 국민 다 확인 했음에도 오로지 조씨 인권 훼손 된것 처럼 보이려는 건 끝 국민 개돼지 그냥 살어라 하는것과 똑같다 그렇게 인권위 국민 청원 넣으면 팬 관리 다 되는 것 이런 나라 살 있다는 그 사실 비극 국민 진빚 없고 오로지 권력 구가 권력 유지 함몰 돼 억척스럽고 사악함에 사로집힌 그런 자 얼마나 더 잘 보이려 그러는지 하여튼 이 정권 헤 머니한 이상한 짓은 끝 없다 같이 움직여야만 하는 그 이유 무엇 그런 정치 적 행동 마치 무슨 약속 한 듯이 한 몸 움직이다니	FALSE
문 천지 교 교주 광신도 들 범죄자 신격화 하느라 애쓴다 국민 개돼지 보이지	FALSE
그게 실수 그걸 믿으라고 내 돌대가리 이 한심한 똘들	FALSE
문 정부 조국 때문 이 시대 조국 망하겠다 국민 무서운지 알아야	FALSE
문재인 청와대 왤케 실수 많 누 논란 일자 장난 비난 받자 실수	FALSE
개전 문빠 선동 질 하려다 역풍 맞곤 실수 믿을 넘은 지능 떨어지는 전라 달 창밖 없을거다 더러운 족속	FALSE
경향 어느덧 수꼴 신문 그만 볼란다	FALSE
실수 의도 적 명명백백하게 드러났는데	FALSE
국가 기관 전자문서 발송 기관 기안 최종 결재 권 자 결재 발송 조치 수 신기관 수신 절차 진행 됩니다 착오 있을 수 없습니다 또한 최초 기안 단계 부터 최종 수신 단계 구체 적신 시간 적시되 기 때문 거짓 해 명도 금방 드러납니다	FALSE
여론 별로 실수 하면 그만 위 시키니 아래 했을 터 저런 공문 만들었다는거 자체 팩트	FALSE
조국 이그리 대단한가 꼭 구속 해서 가족사 기발 키기 바랍나다	FALSE
조용하면 처리 시끄러우면 실수	FALSE
기레기 님 말장난 하세요 결국 청와대 인권위 통해 조로 남 불의 소위 인권 침해 조사 압력 넣으려 했고 그것 버젓이 개돼지 선동 했다는 사실 불변 잖아 실수 같은 소리 하고 자빠졌네 커버 치려면 좀 말 되게 치 가 문어벙 치매 법 절차 이해 못 한다 든가	FALSE
실수 진짜 국민 개돼지 아는구나	FALSE
국민 여론 좋지 않으면 실수 잠잠하면 밀어 붙이는 그런 식 변명 누가 믿냐 국민 개구리 붕어 개 돼지 보이 봉	FALSE
청와대 인권위 하나	TRUE
거짓말 진짜 잘 하네 그런데 우짜 다 보이는데	FALSE
몸통 깃털 대한 마음 빚 과연 무엇 일까	FALSE
툭하면 실수 툭하면 몰랐다 이렇게 일 하려고 청와대 갔나	FALSE
아이 어느 수준 낳건 국가 책임져야 한다 이 젠 그럴 때 되었다	FALSE
다른 나라 똑같이 할 순 없어요 우리 환경 맞춰야지 근데 양육 대해 국가 책임 분 늘려 야한다는 점 대해 서는 동의 합니다 일본 이 걸 못 했고 미래 장담 할 수 없게 됐거든요	FALSE
우리나라 공동체 안 아이 들 함께 키우던 좋은 문화 전통 있는데 너무 치열하게 살다 보네 내 자식 보고 살았네요 아이 낳고 살 아보 그 시기 맞는 경험 하는게 참 소중한 일 생각 들어 청소년 부모 무조건 잘 했다고 할 순 없지만 그래도 생명 대해 책임 다 하려는 부모 들 잘 지원 해줬으면 좋겠네요	FALSE
모든 생명 존엄 하게 여겨져야 한다고 생각 합니다 그게 대가 낳은 아이든 아이 낳은 어른 들 눈 철 없어 보이는 대 부모 마찬가지 입니다 어른 들 손 잡아주지 않으면 문제 반복 될거예요	FALSE
저출산 저출산 하지말고 낳은아이 잘 키웁시다	TRUE
이 문제 시급하다 진짜	FALSE
모든 아이 들 평등하게 소중한것	TRUE
동물 들 자신 임신 할 환경 됐을 때 임신 하고 돌보지못 할 경우 죽이거나 버리고 아예 뱃속 사라지는 경우 있다 사람 이면 이성 생각 있는 동물 자신 행동 스스로 책임질수 있어 야한다 자신 배란 일만 알고있어도 임신 피 할수있고 콘돔 사용 피임 가능하다 살 부모 된 이 들 대에 부모 된이 들이 다르다고 보나 힘들긴 마찬가지 대에도 안정 된 직업 없는 사람 있고 대는 일자리 없는 사람 많다 늙어서 일을못하는이 들도 많다 대는 가장 신체 건강할나인데 뭘 해도 먹고살지 않나 난 그렇게 배웠다 자기 행동 스스로 책임지라고	FALSE
애 낳는걸 좋게 볼 수 있나	FALSE
체계 적 복지 시스템 접근 해보면 어떨까 선진국 사례	TRUE
오 부모 대 라면 주민 센터 사례 관리 대상 했을 때 태어난 아이 안전하고 건강하게 자랄 수 있는 지원 받게 되는 첫 단추 되겠네요 지지 해요	FALSE
선동 질좀 그만해라 능력 없으면서 본능 하다가 사고 친걸 왜 국가 세금 낭비하냐	FALSE
저출산 문제 엉뚱한데 돈 쏟아 붓는거 보다 태어난 아이 잘 돌봐주는 것 신경 써야하는거 아닌가 싶네요 어린 나이 출산 한 걸 잘 했다고 박수 치는건 아니지만 태어난 생명 사회 함께 지켜야죠	FALSE
복지 예산 늘리면 세금 막 쓴다고 자 한 당 충 들 물어 뜯거든	FALSE
노 총 등 정치 활동 하 수백 개 단체 대한 지 원금 규제 한다고 쓰는 돈 공무원 들 줄여도 게다가 일 할 수 있는데도 연금 등등 어지하 사람 들 줄여도 필요 햐 복지 충분한 재원 마련 할텐데 또 세금 올릴 생각 하 겄	FALSE
애 부양 능력 없는데 왜 낳아서 나라 책임지라 하는거지 가수 할 능력 없음 음반 내면 안되고 운전 할 능력 없음 차 몰면 안되는거지 대체 무슨 억지 임 난임 부부 장애인 등 스스로 선택 아닌 부분 국가 지원이 필요하지만 당신 들 불장난 태어난 애 당신 들 키우길 제발	FALSE
차라리 아이 명당 씩 지급 하는 방법	FALSE
선택 한 사람 힘들어도 책임 져야 한다 국가 계속 나서게 되면 모든 학생 들 지금 뉴스 될것이다 책임 회피 할수 없다는 것 확실히 깨닫고 자신 들 처지 알아야 한다 그렇지 않아도 세금 많은데 얼마나 더 올려서 서민 들 죽일려고 하는지	FALSE
결론 대한민국 후진국 거 어제 오늘 일도 아닌 걸 뭐	FALSE
대부모 뿐 아니라 모든 부모 산부인과 원스톱 연결 된 국가 넉 지 원 체계 있어 야한다	FALSE
미혼 부 싱글맘 싱글대 디도 지원 해라	TRUE
난민 미등록 체류 자 도대체 왜 특별 관리 대상 우리 국민 누구 먼저 특별 관리 되야 되는거 아니야 이 나라 도대체 누구 위 나라 모르겠다 미혼모 가정 한부모 가정 살으라고 하는 건지 죽으라고 내 모 지 모르겠다 최저임금 이나 받아야 정부 보조금 조금 받는거 외 숨쉴 구멍 없고 난민 체류 자 국민 우선 순위 된다는게 개탄 스러울 따름	FALSE
제 어린시절 보낸 대 와 대 중반 중림동 달동네 아니었어요 그냥 중산층 들 살던 정갈한 한 옥촌 이었지요	FALSE
영화 감명 깊게 잘 봤습니다 보기 드믄 위인 그 힘든 곳 자발 적 먼저 사랑 실천 이태석 신부 님 존경 사랑 합니다 ♡ 기념관 곧 찾을 예정 이	TRUE
너무 슬프다 잊지 않고 평생 기억 해야 할 신부 님 삶 너무 아름답다	TRUE
이런 분 오래 사셔야하는데 너무 빨리 돌아가셨어요 ㅠㅠ 하나님 정말 천국 태 석 신부 님 필요하 셧 봐요 ㅠ 우리 송이 토토 동 이 보시 잘 보 담아주세요 ㅠ 항상 기도 하겠습니다	TRUE
저 무신론자 신부 님 보며 정말 신 있지 않을까 생각 들었습니다 감사합니다 고맙습니다	TRUE
을 들여서 과연 저런 건물 지을 일이 저런거 하지말고 이태석 신부 님 하신 일 이어서 수단 아이 들 위해 을 쓰는게 훨씬 더 현명 한일 아니냐 나 저런거 보면 참 답답하다 ㅉㅉㅉ	TRUE
저 그 생각 들었네요 이태석 신부 님 뜻 기리 것 좋지만 궂 저리 크고 웅장 하게 좋은 건물 지어서 기리 는걸 과연 고인 좋아 하실까 하는 생각 듭니 저 크고 비싼 돈 들여 지은 건물 인해 이태석 신부 님 깊은 뜻 사랑 같이 묻힐까 걱정 되네요	FALSE
이태석 신부 님 톤즈 학교 지을 때 만약 신 계신다면 교회 먼저 지을까 학교 먼저 지을까 하고 아마도 신이라면 학생 들 즐겁게 다닐수 있는 학교 먼저 지을 것 하셨죠 정말 거룩한 생 사신 의사 이자 종교인 이자 선생님 이셨죠	TRUE
톤즈 도와주지 오늘 신부 님 정말 하느님 데려가지 말았어야 해 실수 셨 어	TRUE
중학생 때 이태석 신부 님 다큐멘터리 보고 난 후 고등학교 진학 아르바이트 하며 정기 후원 시작 했습니다 덕분 소중한 인연 만났고 앞 계속 될 것 입니다 항상 기도 하겠습니다	TRUE
정말 존경 합니다 신부 님 허나 이 건물 지을 돈 톤즈 아이 들 도왓다 신부 님 더 기뻐하시지 않앗을까요	TRUE
하나님 뜻 먼저 가신 이태석 신부 님 그 의 헌신 사랑 누구 보나 가난한 이 들 위해 희생 봉사 그 행동 말로 표현 못 할 존경 표 합니다 아멘	TRUE
이태석 신부 님 아름다운 향기 잊지 않겠습니다 어디 계시던 이제 아프시지말고 몸 마음 평안하시 기를 기도 하겠습니다	TRUE
우연히 울지마 톤즈 보고 이태석 신부 님 알 되었습니다 저 분 신 보내신 천사 아니었을까 생각 들었어요 저 스스로 되돌아보며 조금 더 의미 있는 삶 살아야겠다 깨 달았습니다 감사합니다	TRUE
톤즈 아이 들 어떻게 되는 건가 최소한 도움 주었으면 좋겠어요 그 래야 고 이택석 신부 님 맘 편히 눈 감으실수 있을것 같아요 ㅜㅜ	TRUE
존경 합니다 신부 님 하늘나라 평온하시길 기도 드립니다	TRUE
제 아는 한 진정한 어른 아직 저 이태석 신부 님 뿐 전 종교 없지만 울지마 톤즈 보면서 눈알 빠질 정도 아프고 머리 깨지는 것 같은 고통 느끼며 울었네요 ㅜㅜ 그 곳 안 아프시고 평안하시죠 신부 님 ♡	TRUE
동감 합니다	TRUE
저 도 과연 신부 님 좋아하실까 요	TRUE
카페 청년 들 자립할수 있는 공간 입니다	TRUE
크리스마스 특집 아이 들 함께 울지마 톤즈 보고 아이 들 이태석 신부 님 보고 싶다구 해서 신부 님 잠들어 계신 담양 천주교 묘역 다녀왔습니다 종교 떠나 사람 왜 함께 살아가야 하는지에 대해 많은 깨 닮음 느끼게 해주셨습니다 감사하고 똑 감사합니다	TRUE
각박한 현실 치이는 나날 보내고 있었는데 오늘 이런 따뜻한 기사 찾아 뵙게 되어 영광 입니다 신부 님 보내오신 따뜻한 생애 마음속 되새기며 따뜻한 세상 만들어 가는데 조금 이바지 하도록 노력 하겠습니다 대건 안드레아 드림	TRUE
이태석 신부 님 오래 사셨어야 하는데 톤즈 아이 들 눈물 참 잊혀지질 않네요 슬프다	TRUE
성부 성자 성령 이름 아멘 에 세례 받은 청년 남성 다니엘 입니다	TRUE
너무 아름다운 사랑 를 보았다 눈물 난다 짧은 삶 영광 삶 살다기 셨 다 주님 품 편히 쉬시길 기 도합 니	TRUE
신부 님 감사합니다 닮아가며 노력 하며 살아가겠습니다	TRUE
평화 노벨상 주세요 의미 있는 삶	TRUE
울지마 톤즈 를 통해 알 된 이태석 신부 님 당신 실천 하는 봉사 숭고한 희생 정신 절대 잊지 않겠습니다 본받아 그 봉사 하는 삶은 아 니드 노력 하며 살겠습니다 세상 가쟁 존경 하는 이태석 신부 님 그 곳 아프지 마시고 편히 쉬시길 기 도합 니	TRUE
또 바 가슴 미어 집니다 반성 마니되 고요 아직도 남수단 그 불쌍한 사람 들 오늘 배고픔에 잠도 못 이루는 사람 들 많겟네요 여기는 버려지는 음식물 많은데 ㅠ 세상 왜 이렇게 불공평하는지 최소한 굶주림 시달리지 않는 공평함은 잇어야는데 이 신부 님 제대로 눈 못 감으 셧 듯 ㅠ	TRUE
너무 눈물 많이나네요 신부 님 고귀한 삶 많은 가르침 주셔서 감사합니다 고통 없는 곳 영 하시길 기원 합니다	TRUE
절대 잊지 않게 습니다 신부 님 정말 존경 보고싶습니다	TRUE
대단히 훌륭한 분 입니다 전두환 이명박 같은 사람 하 곤 비교 안되네요	TRUE
짧은 인생 너무나 큰 일을하셨고 멋진 하나님 참 사랑 실천 가셨군요	TRUE
예수님 사랑 이러했을까 기독교 떠났지만 신부 님 숭고한 사랑 가슴 뜨거워지네요	TRUE
정말 너무나도 대단하신 분이내요 크게 감동 받고 마음 따뜻해진 시간 이었습니다 이런 분 이제야 알 된게 너무나 창피 하내 하늘나라 편히 쉬세여 존경 합니다	TRUE
내 마음속 성 이태석 신부 입니다 ㅠㅠ	TRUE
진정한 교육자 삶 필요한 지혜 가르치는 진정한 선생님 이런게 교육	TRUE
신부 님 존경 존경 합니다	TRUE
주님 왜 이렇게 빨리 신부 님 데려가셨나요 톤즈 울 지 마 보며 제 자신 다시 돌아보게 되었습니다 부디 그 곳 아픔 없이 평안하시 옵소서 아멘	TRUE
사랑 뭔가 깨닫게 합니다 이태석 신부 님 존경 합니다	TRUE
왜 좋은 사람 데려 가시나요 세상 악인 남겠어요	TRUE
왜 이런 분 이렇게 고통스러운 병 이렇게 빨리 데려가셨을까요 하나님 뜻 제 머리 도저히 이해 안됩니다 종교 대한 회의 느껴지는 순간 입니다	TRUE
신부 님 사랑 합니다	TRUE
훌륭하 신분 오늘 세 삼 더욱더 알았어요 제 자신 부끄럽네요 천국 편히 쉬세요	TRUE
우리 아직 따뜻한 사람 존재 합니다 울지마 톤즈	TRUE
기념관 차릴 돈 수단 어려운 사람 돕지	TRUE
기념관 있어 고인 되신 신부 님 뜻 더 널리 잊혀지지 않고 널리 알리고자 함이겠지만 ㅜㅡㅜ 모르겠습니다 고인 뜻 기려 남수단 아이 들 주민 들 삶 힘 되어주는 연 계 사업 지원 그만큼 있으리라 믿고 싶습니다 ㅜㅡㅜ ㅜㅡㅠ 휴	TRUE
사랑 합니다 존경 합니다	TRUE
신부 님 사랑 존경 합니다 ♡	TRUE
한번 꼭 방문 하고자 합니다 마음 깊이 나눔 담아 갑니다	TRUE
신부 님 주님 곁 늘 편안하세요 사랑 존경 합니다	TRUE
톤즈 아이 들 좀 도와주지 신부 님 아마 그 걱정 때문 천국 걱정 하세요 관계자 분들 아셨죠	TRUE
이분 배울 점 많은 사람 이긴 하지	TRUE
영원한 당신 감사합니다	TRUE
영원한 당신 감사합니다	TRUE
김희중 주교 님 박근혜 탄핵 사 기 탄핵 거기 대해 서는 여태 입 꾹 다물고 계시는게 공정 정의 입 정치 주교 님 이 시 자 요	FALSE
결혼 하는 순간 그 성직자 아닌 가장이 된다 가족 위해 부를 쌓기를 강요 받을 것 자손 들 위해 자신 힘 이용 부의 세습 위해 각종 위법행위 할 것 이는 개신교 부자 목사 들 통해 검증 되었다	FALSE
그런데 하나님 섬기는데 무슨 자신 재능 온건 히 바쳐 야함 존재도 안 하는것 모시는데	FALSE
마치 일반인 들 위법행위 이해 되고 용납 된다는 말 같네 ㅋㅋ 그런게 두려우면 아예 성직자 무인도 서 살 하지 그러냐	FALSE
처 자식 생기 무조건 부패한다 없어도 부패하는 곳 종교 집단 처자 식 있어 봐라 안 봐도 비디오 처자 식 허용 한다면 내 후손 들 반드시 신부 님 만든다	FALSE
사제 대한 두 교황 의견 엇갈린다고 해도 어느 의견 옳다고 하긴 어려울 듯 전통 지키느냐 문제 해결 위해 예외 두느냐 이 어려운 숙제 현 교황 어떻게 결론 낼 궁금하다	TRUE
가톨릭 고려 해보겠다라는 건 한 뒤 논의 시작 해보겠다 하는거에요 가톨릭 얼마나 보수 적	TRUE
성직자 성추행 문제 해결 하시오 카톨릭 신자 들 교황 님 사과 했잖아요 이러 대요 잘못 저지르고 사과 하면 다인 법적 재판 받고 감옥 넣어야지	FALSE
교황 정체 뭐 뱀 렙틸 리언 자체 의미 하는 게 아닌거 같은데 근데 나 렙틸리언 실존 한다고 생각 하 거든 뱀 머리 둔 이집트 코브라 여신 와 제트 만약 렙틸 리언 라면 이집트 피라미드 안 파충류 숭배 하는 조각상 하나 정돈 나와야하는데 개 고양이 조각상 있어도 그런 건 없어	FALSE
아 복잡해졌다 뱀 눈 가진 존재 있는거지 렙틸리언 없는 건가 분명 뱀눈 깔 사람 존재 하는데	FALSE
사제 들 결혼 허용 한다면 천주교 종 속 가능성 없지요 아버지 로서 신부 아내 자식 우선 이기 재산 축적 배임 횡령 교회 재산 다 빼 돌릴것 임	FALSE
독신 신분제 카톨릭교회 자산 때문 시행 된건데 신앙 때문 개구 라가 오늘날 통한 다니 ㅋㅋ 신부 술 먹고 담배 피우고 섹스 하는데 결혼 못 하게 하는게 정상 ㅎ	FALSE
진짜 대박	TRUE
배우자 아닌 사람과 성관계 하면 고해성사 해야 돼요	FALSE
참고 가톨릭 초대 교황 말 하는 베드 기혼 자임	FALSE
목사 처 먹을거 다처 먹고 떡 칠거 다치고 돈 벌거 다 벌고 하는데 무슨 성직자	FALSE
아직 안 가셨네요 염 추기경 같은 부류 보이네요 어쨌든 프란치스코 교황 님 후임 하신것은 업적 요	FALSE
그냥 간단히 말 해 사제 가장 겸업 불가능 둘 중 한가지 어려운 노릇 둘다 어찌 함	FALSE
하느님 부르셔서 그럴 걸	TRUE
꼰대 어딜 가나 문제 군	FALSE
그럼 남자 여자 뭣 하러 있어 아예 결혼 안 할거면 자웅이체 살 그래	FALSE
거룩한 척 하더니 권력 맛 보니 변했나	FALSE
신 모시는 사람 간단하게 그냥 신 모셔라	FALSE
돈 목적 종교 만든건 디 돈 많은 곳 몰리 개 되는거고 종교 믿고 오래 정직하 게살 은자 잇 남	FALSE
천주교 북한 후빨 종북 단 요것 들 그러나	FALSE
노스트라다무스 예언 의하면 이번 마지막 교황 아닌가	TRUE
■ 중간 베네딕토 세 사진 다스 시디 어스 빠 언리미티드 빠	FALSE
팰퍼틴 다스 시디 어스 황제 부활 하더니 전임 베네딕토 교황 서도 다시 목소리 내시 언리미티드 빠	FALSE
천주교 이미 타락한 종교 한국 더 말 할 것 없고	FALSE
문 둥이 손잡아 주시던 주 예 수 그 리도 보고 여 신자 손 때리던 너 신의 말씀 전하 사제 모습 안보 인 퇴역 농사 지어라	FALSE
북한 다녀온 종북 사제 들 성 접대 여부 조사해 주세요	FALSE
하늘 아래 두 교황 ㄷㄷ	FALSE
아마존 특정 지역 한정 해도 신부 결혼 허용 카톨릭 굉장히 파격 적 결정 보수 적 신 부들 사이 당연히 말 나올수밖에 없는 일이 약간 의견 충돌 있다 해도 이 것 카톨릭 분열 되지는 않는다 두 교황 사이 비유 하자면 시어머니 며느리 같은 사이 같다고 할까 ㅋㅋㅋ	FALSE
사제 혼인 가능한 성공회 정교회 진출 하면 되겠네요 천주교 사제 독신 문제 고민 하지 결혼 싶으면 딴 데 가서 알아보라 그러면 될것을	FALSE
너무나 아까우 신분 존경 합니다	TRUE
이름 들어도 눈물 납니다 이런 분 왜 이리 빨리 데려가신 건지 ㅜㅜ	TRUE
존경 합니다 이 하찮은 생명 역시 만인 위 한 줄기 등불 된다면 그 값 진일 없을것 입니다 그대 주 그대 극락 아닐까 하는 생각 이듭 니	TRUE
이 시 대의 성인 개인 적 생각 합니다 정말 존경 합니다	TRUE
검찰 개혁 방해 하기 위 하여 없는 죄 만들기 위 윤껌 수사 국민 정서 황폐 화 시키고 있다 검찰 개혁 완성 축하 드립니다 국회 검 경 수사권 조 정법 모두 처리 검찰 개혁 입법 완료 😀😀😀😀😀“ 윤석열 검찰 내란죄 적용 국민 청원 "==> >https://t.co/619Xvzwn7k https://t.co/KBH5S31kkH	TRUE
결혼 하지 않는 자는 주님 사업 온 마음 다 할수 있습니다 오늘날 개신교 엉망 진창 이유 결혼 하기 때문 온갖 사리 사욕 부리는 것 내 보기 저건 사제 없다는 이유 프란치스코 교황 자신 마음대로 결정 해 버리는게 아닌가 싶다 그리고 잘 못 된 일 지적 하는게 어찌 교황 간 싸움 말 할 수 있으며 그러면 교황 무슨 짓 해도 다 받아들여야 한단 말 진정 가톨릭 위기 건 사실 같다	FALSE
천주교 내 풀 성경 다시 검토 하세요 우리 받을 상 하늘 세상 아니요 난 이미 완전 장악 된 상태 도움 절실 히 필요합니다 세상 누가 악담 선호 합 우리 싸울 대상 공중 잡은 권세가 즉 뜬구름 잡은 권력자 결국 나도 여러분 죽음 필 할 수 없는 법 내 곳간 탕 비어 있고 이제 굶주릴 지경 이 왜 하느님 섬김것이 죄 되는 세상 난 도무지 이해 못 하겠어요 음행 하지 말라하면 뒤 더욱 심하고 조롱 비웃고 사랑 한다고 말 하는 것 사랑 가르칠 당신 들 없을 것 이	FALSE
이 젠 내 항복 할 심정 놓여있어요 내 주위 완벽하게 장악 되어 있어요 교항 청과 다리 놓아주시요 더 이상 쓸데없는 세 상권 력 가의 아첨 꾼 되지 말길 다음 달 관련 된 실물 이름 광야 거론 할 것 이 이 젠 나도 죽 작정 이 더 이상 괴로워서 못 참겠어요 선량한 사람 이용 당하면서 피해 보고 있을 뿐 차라리 이 한국 떠나는 것 더 나을 것 이 아무런 도움 없이 지금 이 순간 철저히 농락 당할 뿐	TRUE
처 자식 있는 종교 지도자 당연히 욕심 생길 수 없는 것 그 욕심 채우려다 보니 부정부패 비리 저지르게 되는 것 인간 오늘날 기 도교 등 결혼 종교 지도자 들 보면 왜 종교 지도자 처자 식 거 느려 서는 안되는지를 알수 있다 결혼 한 종교 지도자 하는 욕심 버리라는 말 거짓 사기치는 술수 불과하다	FALSE
개독교 개슬람 개 대교 다 쓰레기	FALSE
교황 충돌 하는게 아니라 그나마 가톨릭 지금 사제 들 독신 유지 해 왔기에 지금 청빈 삶 유지 할 수 있었다 교황 끼리 충돌 아니라 예수님 말씀 하신 것 음욕 참을 수 없겠거던 결혼 하여라 하셨고 사도 바오로 역시 여러분 나와같이 결혼 하지 않기를 바랍니다 결혼 하게되 면 아내 암 편 어떻게 하면 기쁘게 할까 생각 남편 어떻게 하면 아내 위 할까 생각 하게 됩니다 그러나 결혼 하지 않는 자는 어떻게 하면 주님 기쁘게 할까 생각 하게 됩니다 하신 것	TRUE
수 천년 전 사제 독신 여부 대한 내용 없어요 참고 하시고 틀 박히지 마시길	FALSE
배 다른 형제 품는 모습 쉽지 않습니다 특히 어머니 마음 고생 하 모습 옆 봤다면 더 하죠 아버지 가 나쁜 겁니다 모두 상처 주는 결과 일 뿐 포 용한 임재범 씨 해당 당사자 자식 들 모두 대단하다 생각 합니다	TRUE
남자 반드시 뿌리 찾아가게 되있다죠 그래서 아들 없는 아버지 앙꼬없는 찜빵 입니다 남자 마음 헤아리는건 늙어가는 아들 엄마 마음 헤아리는건 늙어가는 딸 한다 암튼 임재범 씨 손지창 씨 멎 집니다	TRUE
미사 한번 빠지면 고해성사 받아야 되서 부담스러 움	FALSE
천주교 답지 않게 너무 정치 세력 가까이 하는 것 이 것 문제 생각 합니다 또한 김수환 추기경 님 계실 때 어른 같은 존경 신부 없다는게 그것 문제 생각 되요	FALSE
개신교도 가톨릭 불교도 예전 큰 어른 많이 없어졌죠 그런데 가톨릭 어딜 봐서 정치 세력 가까이 하나요 신부 님 강론 말씀 때 특정 후보자 지지 하는 것 없고 한기총 조직 적 특정 정당 옹호 하지도 않은데	FALSE
jung 어디서 헛소리 하냐	FALSE
가난한 형제 들 멀리 멀리 부자 들 앞 꼬리치는 신 부들 역겨워	FALSE
진심 이런 신부 님 들 가끔 봤지	TRUE
부모 신자 첫째 둘째 세례 받았고 막내 을 성당 다녔는데 막내 세례 받을 시기 부모 첫째 둘째 때 가정 교리 이 수 함 가 직장 문제 가정 교리 못 받는다고 세례 안 준다는 편엽 해진 천주교 어릴 때 부모 신자 아니다는 이유 세례 받는것 한번 거부 당했던 나 막내 인한 두번째 버림 받음 세번 째 버림 받기 싫어 내 천주교 버리기로 결정 융통성 관용 없는 종교 무슨 종교 말 할수있는지	FALSE
한국 천주교 까다로운 절차 형식 젊은 신자 들 멀어지게 하는 이유 있을 것 입니다	FALSE
외형 규모 집착 하기보다 내적 질적 성장 신앙 실천 주력 해야 함	FALSE
하느님 결혼 하 처자 식 없다고 그러 도니 처자 식 있는 사람 들 제일 지 한 몸 챙기고 들 있음 자정 하지 않으면 외부 의해 자정 당한다 그래서 자정 능력 능력	FALSE
돈 없으면 종교 생활 힘들어 요미 사가서도 존재 자체 미미해서 힘빠져 오는 경우 많음 감사 헌금 기 타 헌금 등등 어딜 가나 돈 없으면 대우받기 힘들어	FALSE
애 들 데리 가기 어려워 자연스레 냉담	FALSE
그냥 기독교 역사 속 사라져라	FALSE
불교 유교 제사 있으니 싫고 종교 있어야겠고 기독교 교회 바라는게 많고 천주교 신자 제사 있어도 그만 없어도 그만 편리 주의 따라 등록 많이 했나 보네 그게 무슨 신자 내 주변 천주교 반지 악세사리 차는 사람 많이 봤다 성당 일 년 한번 나갈까 말 까한	FALSE
콘스탄티누스 황제 세기 현재 본다면 깜짝 놀랄듯 ㅋㅋ 자기 권력 통제 용 만든 구라 이 넘도록 남아있을 거 누가 알았겠어	FALSE
좌빨 처 먹고 헛소리 하는 신부 놈 들 때문 안 간다 애 낳고 키워 봐야 인간 본능 이해 하는데 아무 것 모르는 철 없는 일부 신부 놈 들 때문 천주교 다 버렸다	FALSE
개신교 하도 씹어대 어서 꺼리지	FALSE
응원 해요 많이 많이	TRUE
니 중 테러 이용 된 게 밝혀지면 왜 계죄 정지 하 않있냐고 하겠지	FALSE
어느 나라 인지 대해 서는 비공개	FALSE
야 니 뭐 하냐 은행 특정 국가 출신 계좌 막은거나 니 들 아무 근거 없이 몇몇 이 들 추정 은행 역 하는거나 뭐 다르냐 역시 진보 오로지 나 정의 하는 저 독선 아주 신물 난다	FALSE
노숙자 들 빨래 해서 널어 말리 술판 벌이 담배 피는 건 보통 문제 어떻게 손 볼지도 좀 알려 주세요 서울역 인접 곳 특히 여름 공원 통과 하는 것 꺼려지고 밤 아예 우범 대가 되는 무서운 곳 서소문 공원 돈 달라 담배 달라 무시 지나치면 쌍욕 침 뱉고 소 주병 던지는 살벌한 서울역 노숙자 문제 해결 해 주세요	FALSE
이래 찬남 이민 넘 누 군 했더니 적그리스도 편 세력 ncck 홍 정길 내 홍 정길 봤지 광주 예배 광주 한빛 교회 설교 하러 왔 더 ㅋ 난 그냥 모르고 갔는데 호남 신학교 오현 선교 수문제 로만 호 신교 권 회복 위원회 호 신 대 졸업 좌파 목사 들 재단 교섭단체 목 사퍼 함 운동권 출신 들 소개 처음 예배 지난번 갔을 때 본 얼굴 홍 정길 주시 파 목사 ncck 한국 교회 협의 회 동성애 지지 옹호 한 미군 새 훈련 반대 뒤 미군 철수 지지 하 세력 것 알수있다 얼 마나미 굳 트럼프 대통령 꼬셔 이용 할려고 폄지를 써 대는지 한 미군 새 훈련 하지말아 달라 등등 들 의구 ㅐ 계 사 단 의궤 계 그럼 그렇지 지난번 이인영 종교 걔 만나 경제 북한 문제 협력 해달라 고간 곳	FALSE
사탄 마귀 들 끼리 싸우는거 봤음 양 가면 쓰고 이리 질 하는 삯꾼 들 왜 죽음 길 함께 가나 혼자 들 가시 성도 들 눈 밝히 뜨세요	FALSE
Ncck 는 좌파 기독교 단체 절대 속으 안된다	FALSE
저런 유사정 교인 빠지는 사람 들 수준 자체 일베 베 아닌가	FALSE
사회주의 해서 타락 안 빠졌냐 한심하다 앞 국민 없어지는데 낙태 찬성 하는 민주당 국민 앞 석고 대죄 해산 하	FALSE
사랑 교회 관련 누적 확 진자 명 코로나 전도사 전광훈 손해배상 신천지 급 소송 불가피 국가 적 피해 고려 할 때 도 적다 단계 만들어서 라면 형제 비극 초래 하게 만든 전광훈 보석 시켜 준 두 명의 판사 구상권 청구 해야 한다	FALSE
국가 위기 일 때 종교 안 나서면 누가 하나요 독립 선언문 낭독 인 자랑스러워 하는 후손 들 나라 사회주의 간다 해도 침묵 하 강요 하는 기자 들 어느 나라 사람 공산주의 찬양 하는 지도자 찬양 하는 종교 지도자 소경 이끄는 소 경일 뿐입니다	FALSE
공산주의 찬양 한다는 구체 적 수치 적 증거 요	FALSE
저 작 은동 네 또 경리 단길 꼴 나는거 아닌가 몰라	FALSE
별거 없는 데 언론 또 선전 하네 뭐 의 놀이터 그냥 그런 동네 약현성당 유명하고 나머지 조금 달라지는 지금 추세 일 뿐	FALSE
동네 분 이 라면 그리 폄하 할 이유 뭐 있나요 다른 동네 분 이 라면 그리 배아 파 마 시유 침체 된 동네 부는 변화 관심 저 오래 산 주민 들 반길것이외다	FALSE
맞는말 하셨는데 뭐 문 젠 가요	TRUE
많이 바 껴서 좋은데 요 예전 별 볼일 없었지 오히려 더 바 꼈으면 하는데 빈정대시네요 ㅋㅋ	FALSE
조만간 우르르 몰렸다가 월세 고공 권리금 억억 하다가 남는거 없이 세 입자 들 쫒 겨 나가겠지	FALSE
여기 조금 지나면 임대료 오르고 젠트리피케이션 일어나겠지 좀 그냥 놔둬라	FALSE
막상 가보면 쥐뿔 없음	FALSE
지금 이런 기사 올릴 때 아닐텐데 나라 경제 완전 박살 나서 압구정 삼청동 동대문 뭐 완전 다 박살 났던데 층 상가 들 완전 공 실 텅텅 빈 데 천 지드 이 거 뭐 하자 얘 긴지 국민 들 그렇게 우습게 보여	FALSE
그게 나라 망한거냐 집주인 망한거자 앞뒤 분간 못 어디서 가짜 뉴스 줏어듣 왔니 하여튼 멍청한 애 들 선동 잘 당해요 ㅉㅉ	FALSE
박원순 하이라인 벤치마킹 해서 서울 만들었다는 말 도대체 믿을 수가 없음 베 낄 거 똑같이라도 베 끼던가 선유도 공원 가 본 적은 있나 몰라 워싱턴 가서 뭐 하나 베 껴서 용산 공원 만들려는 모양 데 박원순 같은 애 용산 공원 맡기면 절대 안 됨	FALSE
이 동네 살고있는데 그냥 그냥 조 용한 동네 카페 옛 건물 리 모델링 해서 쩜 늘긴 늘었는데 핫 플 레 아니고 그냥 그 사람 많아질까봐 걱정 되네	FALSE
백 주 부가 또 맛집 어쩌구저쩌구 해야지 체인점 나가구	TRUE
인스타 인증 용 카페 식담 넘치다가 임대료 치솟고 올리브영 브랜드 커피 들어서고 초기 자영 업자 떠나고 임대 공 실 젠트리피케이션 얘기 나오겠군	FALSE
그럼 뭐 하냐 곧 돈 냄새 맡은 놈 들 모여들어서 싸 그리 산다음 임대료 올리고 못 버틴 세 입자 들 쫓겨날텐데 ㅉㅉ 지금 그렇게 날려 먹은 곡 한두 군데 아니지 이태원 익선동 북촌 하여간 한국인 들 황금알 낳는 거위 배 가르는걸 참 좋아해 욕심 가득 차서 뒷일 생각 안 하지	FALSE
문 재앙 뉴스 보다가 이런 걸 보니 기분 전환 되는군	TRUE
경리 단 보고 또 그 짓 하여튼 투기 충 들 문제	FALSE
작작 들 해 경리 단 꼴 난다 휴	FALSE
다른건 몰라도 맛집 리스트 들 진짜 임 ㅇㅈ 각	TRUE
경제 신문 이익 집단 광고 반박 해봐	FALSE
어차피 임대료 때문 망하고 최저임금 때문 망했다고 언플 할텐데 머	FALSE
또 시작 ㅓ ㆍ 랏돈 사업 비 ㆍㆍ 거리 만들고 남겨 먹고 튀는게 패거리 들 문화 사업 언론 기레기 들 한 통속 부동산 값 올리게 몰려들가지 맙시 속 지 맙시 나랏돈 지 들 배 불리는 수 작 질 아녔는가	FALSE
인사동 전통 공존 하는 동네 무조건 젠트리피케이션 일어남	FALSE
고가 흉물 없애 버려라	FALSE
한경 가만 보면 기획 성 기사 많이 싣는 듯 전형 적 띄우기 수법 일 수도 있는데 장사 하시는 분들 맘 편하게 장사 하게 그만 좀 해주면 좋겠네 이렇게 해서 덕 보는 사람 중간 상가 사놓고 기다리는 사람 더 있나 언론 좀 언 론다 워 지 경 제지 곳 개인 블로그 같은 홍보 기사 쏟아내고 있으니 암담하네 정말	FALSE
월세 올라가는 소리 들리는구나	FALSE
젠트리피케이션 가야져	FALSE
이제 익선동 끝	FALSE
응 땅값 조작 기사 ㅋㅋ	FALSE
광고 오지네요 지역 더 좋은 곳 들 많습니다 기레기 님	FALSE
맨날 뜬다고 해서 가보면 개판 임 진짜 뜬 곳 냉정히 을지로 없다	FALSE
경리 단 꼴나지	FALSE
이제 그만하고싶나 보네 기 사내면 끝 이제 커피숍 들 들어서고 휴대폰 가게 들어서고 한국 사람 성질 몰라서 이런거 올 리나	FALSE
요즘 핫 플 업주 들 이런 기사 싫어하지요 이 기사 인해 잠깐 유행 된 후 경리 단 길 될 겁니다	FALSE
중림동 땅값 올릴려고 별 지뢀 다 하네	FALSE
신천지 냄새	FALSE
이 긴자 새 언약 흰 무리 등 신천지 특정할만 한 증거 안 보임 결정 적 탄소세 주장 할만큼 신천지 머리 좋지는 않음	FALSE
교회 세금 걷어 야한다 동네 엄청난 땅 단독 건물 어마어마한 교회 몇개 씩 있다 세금 안 걷으니 돈 주체 못 하더라 예수 계좌 없다 십일조 다 교회 거 교회 목사 거지	FALSE
천주교 세금 냅니다 개신교 대 체적 안내서 그렇지	FALSE
천주교 원래 세금 냈는데 뭘 알고나 좀	FALSE
개신교 세금 냅니다 대 체적 천주교 불교 안내	TRUE
ㄴ 대놓고 구라치면 안 쪽팔릴까	FALSE
어휴 기사 똑바로 보고 말 해라 ㅋㅋ 저 기독교 천주교 관련 된 거지	FALSE
기독교 천주교도 포함 하는 개념 입니다 어차피 종교 불교 빼고 교리 유일신 섬기라 하는 곳 ㅋ	FALSE
돈 쌓아 두는 교회 문제 사회 세금 더 많은 돈 기부 하는 교회 많습니다	TRUE
기부 하는 돈 같은 종교 집단 기 부란 목적 전도 하는 짓거리 하니 문제 그리고 세금 더 많은 돈 기부 사는 교회 있으면 명시 해보길 큰 교회 라면 교 갈취 하는 돈 금액 엄청나고 그 수익 대한 세금 내다면 몇십 프로 될텐데 그런 금액 순수한 마음 기부 하는 교회 하나 없음 돈 환장해 신도 들 주머니 강탈 하는게 개신교 스스로 일컽는 신의 종 들 신 의종 들 아니라 물질 종	FALSE
hybr 당신 순수한 마음 사회 기여 하는 교회 없다는 주장 근거 대 보시 다수 대형 교회 타락하여 정계 영합 물질 만능 주의 찌들긴 했으나 기독교 교리 이웃 사랑 강조 하며 불우한 사람 돌볼 것 명 있다 실제 헌금 상당 액 그런 사회 기여 위해 쓰이고 있고 떠들더라도 뭘 좀 알 객관 적 근거 갖고 떠드시길 참고 종교 계 세금 납부 나도 찬성 한다 성경 조세 관세 받을 자 바치 나온다 로마서	FALSE
딱 신문 급 느껴지는 광고	FALSE
한겨례 광고 한다는 자체 구림 ㅋㅋㅋㅋㅋㅋ	FALSE
신천지 아냐 기독교인 들 신천지 방치 하는 바람 온통 신천지 천국 기독 교 반성 행	FALSE
개신교 목사 신도 사형	FALSE
정구사 하겠어	FALSE
유사 종교 기준 무엇 인지 관계자 들 댓글 부탁 합니다	FALSE
성소수자 차별 누가 했는데 오히려 역차별	FALSE
한쪽 이념 찌든 종교 단체 민주화 혹은 정의 사회 구현 하는데 저해 있다	FALSE
성소수자 변태 성 성욕 자 지정 하여 형사 처벌 하면 싹 없어짐 소 수 성애자 성매매 한국인 정서 맞지 않기는 마찮가지 근데 대체 버닝썬 어떻게 되는 건지	FALSE
변태성욕 자 들 치료 가능하니까 성소수자 헛소리 하며 방치 하지 치료받고 다시 건강하게 사세요	FALSE
더러운 인간 들 징그럽다 🐕 노 ㅁ 들아	FALSE
게이 부모 새끼 게 자랑 ㅋㅋㅋ	FALSE
사람 들 천주교 하나님 예수님 믿는 종교 착각 하는데 천주교 성모마리아 섬기는 종교 임 걍 이슬람교 통일교 등 다를게 없다는 거	FALSE
종교인 들 이 래야 한다 저기 빤스 사이비 아닌	FALSE
두 종교 지도자 님 전광훈 지옥 기도 부탁드립니다	FALSE
전광훈 악귀 보고있냐	FALSE
예수님 오신 날 또 하나 아름다운 실현 입니다	TRUE
현 기차 노조 포함 이 라면 예수 대한 모독 입니다	FALSE
이 땅 고통 받는 노동자 분들 오늘 하루 쉴수 있기를 간절히 바 봅니다	FALSE
당신 환자 입니다 아픈 사람 마음 병든 환자 치료 필요한 환자	TRUE
한겨레 답 다	TRUE
진짜 노동자 그런 미사 안 간다 귀족 정치 노동자 들 정치 미사 가지 기레기 언론 전교조 같은 인간 들 간다 이 것 뉴스	FALSE
열악한 환경 일 하시는 분 들 안전 평등 속 일 할수 있도록 작업장 처우 등 개선 하도록 관 사 등 앞장서주시고 혹 그것 역 용하는 단체 노조 조합 없도록 해주시기 바랍니다	FALSE
그래 봤자 전 목사 차이 뭔가 다 똑같아	FALSE
지 랄 풍년	FALSE
제발 하지도 마 그게 노동자 들 더 힘들게 하는거야 내 요즘 들어 느끼는 거지 종교 결국 가 진자 갖는거 같단 생각 든다 니 들 말 하는 노동자 들 주 에 토 일 다 쉬 빨간 날 쉬지도 못 하는데 언제 종교 활동 하냐 신은 대체 누굴 위해 있는거며 대체 크리스 마스 언제 술 쳐 먹고 노 날 된거	FALSE
일터 고통 안 받으려면 부자 부모 만나거나 공부 잘 해서 전문직 되거나 돈 많은 배우자 만나거나 아님 때려치던가	FALSE
시진핑 만났으면 미세 문지 얘기 했어야지 문 새 꺄	FALSE
나쁨 수치 아니고 매우 나쁨 최악 입니다 중국 어김없이 날라 왔음 위성 보면 다 나옴 ㅡㅡ	FALSE
문재인 미세먼지 국내 탓 입니다 ㅎㅎ	FALSE
짱깨 들 공장 다 폭파 시키고싶다	FALSE
오늘 지방 일 가족 명 자살 했다 내년 북한 퍼줄돈 우리나라 쓰자	FALSE
이 나 고 무적 능력 잉태 막아주지	FALSE
너 어디가 싸라	TRUE
미혼모 안된다	FALSE
MT 호황 겠네 MT 는 마트 입니다 ㅋ	TRUE
인생 모 아니면 텔	TRUE
문 세 먼지 새끼 넌 도대체 잘 하는게 뭐 간첩 질 자살 당하게 만드는거 빼고 아 참 비 자금 엄청 빼 돌렸다지	FALSE
올 겨울 낙태 할 여자 많이 생기겠군	FALSE
성탄절 요즘 일 가족 자살 소식 너무 자주 들린다 노인 대 남자 자살률 세계 위나라 고독사 일 가족 자살 도 추가	FALSE
중국 공장 지금 멈추게 해야 합니다 이러다 국민 들 폐암 걸려 민족 말살 됩니다 공기 미래 암울한 대한민국	FALSE
오늘 몇 명의 생명 생기려나	FALSE
지금 우리 성탄 기분 낼때 아니지요 국가 형 편이 요지경 걱정 입니다 안보 경제 외교 다 절단 되고 아우성 판국 입니다 정신 차릴 때 입니다	FALSE
Fuck disaster	FALSE
문재인 선사 그레이 크리스마스	FALSE
국내 먼지 보다 온통 중국 발인 대 국내 발전소 죽이고도 날씨 이런대 우리 경제 후퇴 제대로 된 말 한마디 대안 없이 무조건 규제 나도 하겟네	FALSE
헉 미세먼지 차분한 성탄 전야	FALSE
천둥 번개 비도 좀 왔으면 좋겠다	FALSE
미세먼지 해결 포기 한 듯 중국 강력히 항의 제대로 된 대책 내놔라	FALSE
이런 쇼 할 시간 노숙인 안행 기는 정책 펴라 너 네 지금 기초 생활 수급 자 얼마나 양산 하는지 아	FALSE
聖 탄 절 性 탄 절 아닐텐데	FALSE
커플 쉐리 들 잇는 모텔 들 다 폭파 시키고싶다	FALSE
enss 발정 한 남충 같으니라고 넌 연말 그 생각 뿐 니 앞가림 잘 하세 묘	FALSE
중국 발 화이트 크리스마스 아니냐 훠훠훠	FALSE
지구 바퀴 벌 짱개	FALSE
정신 이상한 모텔 방화 범 나오지 말 법 잇냐 ㅋㅋㅋ 오늘 밤 모텔 불 질러서 통구이 되면 볼 할 듯 ㅋㅋㅋㅋㅋㅋㅋㅋㅋㅋㅋ 분명히 나온다	FALSE
사랑 합니다 신부 님	TRUE
사랑 합니다 신부 님	TRUE
천사 살아있는 천 사셨어요	TRUE
고맙습니다 감사합니다 사랑 합니다	TRUE
사랑 합니다 신부 님 ♡ 하늘 나라 아프지 마세요 ♡	TRUE
꿈 대화 노래 들으면 신부 님 생각 눈물나요 투 병중 귀국 하셔서 모금 중 기 타치 부르시던 모습 뇌리 강하게 기억 되고 있죠 신부 님 존경 합니다	TRUE
하늘 아프지말고 영원한 삶 사시길 빕니다 ♡	TRUE
제 제일 존경 하는 분 항상 마음 신부 님 품고 살 있습니다 많이 모자란 저 신부 님 반의 반의 반 닮아가기 위해 노력 하겠습니다 🙏 사랑 합니다 이태석 신부 님	TRUE
평생 이렇게 계속 울며 다큐 본적 없습니다 ㅠㅡㅠ 하늘 애 환희 웃고 계실 것 같은 이태석 신부 님 존경 합니다 감사합니다	TRUE
교회 다니지만 이 신부 님 진짜 존경 합니다	TRUE
신부 님 가르침 따라 제자 들 중 여러 의사 수단 갔다고 하니 넘 감격 적 입니다 ㅜㅜ 토마스 그 새 신부 님 한국 의사 ㆍ 어떻게 사는지 봤으니 힘들겠지만 그래도 신부 님 병원 이어가주시길 부탁드립니다	TRUE
존경 합니다 신부 님 하늘 톤즈 사랑 지켜주세요	TRUE
쫄리 신부 님 하늘 행복하시겠지요 ♥	TRUE
하늘 영원히 사시길 축복 있으시길 ♡♡	TRUE
송철호 아직도 안 내려왔나	TRUE
염 추기경 아직도 그 자리 계세	TRUE
교회 사기 교회 가지 마라 종교 단체 종교 지도자 믿지 마라 타락한 교회 돈 받치고 몸 받치기 스스로 성경 말씀 따르면 된다	FALSE
ㅋㅋㅋ 그럼 목사 뭘 먹고 사 누	FALSE
전광훈 빤스 베 끼는거 비디오 만들면 대박 헌금 하는 시간 가장 기 븐 일이 쟌 어	FALSE
우리나라 개신교 종교 아니다 장사 하는 가맹 점 ㅋㅋㅋㅋ	FALSE
교회 가맹 점 이란 말 동감	TRUE
교회 다니는 사람 들보 하나님 없는것 같다 그냥 영업 사원 들 모임	FALSE
맞아요 다단계 영업 하는 전도 행위 속지 자신 마음 챙김 스스로 해야 할 때 입니다	FALSE
이 거 위험한 발언 영 지 주의 발전 할 수 있는 위험한 사 상임	FALSE
신성 성령 그거 개 소리 솔직 희 당신 신성하다고 생각 해요 자기 신성하다고 생각 하면 양심 속이는거지 목사 들 그래서 사 깃 꾼	FALSE
내 안 살아계신 성령님 되찾는거 아닐까 요	FALSE
한국 교회 토착 샤머니즘 그 자체 조선시대 아니 일제시대 아프면 병원 무당 먼저 찾았고 지금 점집 젊은이 들 바글바글 하다 그만큼 반도 족 들 샤머니즘 빠져있고 이 습성 이용 해서 기복 신앙 교회 다니고 십일조 내면 복 받는다 와 저주 예 수안 믿으면 안좋은 일 생긴다 다친다 를 적절히 버무린 기업 형 예 수 팔이 나라 장악 할 지경 여의도 순대볶음 교회 신자 들 헌금 내기 위해 번호 표 뽑고 기다렸다가 창구 헌금 내고 교회 그 돈 주체 할수 없어서 세금 도안 냄 땅 사고 회사 만들고 자식 들 대물림하는게 정상	FALSE
하모 하모 형님 말씀 백 번 천 번 올 씀니다	TRUE
한국인 피 샤머니증 피 흐른다 절 가도 가장 높은 곳 칠 성신 모시는 칠 성당 있다 개신교 예수 현대 한국인 샤먼 헌금 하고 복 기원 다 논리 이성도 없다 감성 발달 종족 단 적 예 한국말 로만 논문 서술 가능한가	FALSE
제대로 알지못하면 글 쓰지 마시지 안쓰럽네요 교회 세금 안 낸다는건 개 소리 이구 여의도순복음교회 경우 적어도 세금 냅니다 십일조 헌금 내 아무 강요 안 합니다 내지 마세요 내기 싫으면 교회 그런 것 강요 한다 면 님 말 한 대로 사이비 맞습니다 헌금 십일조 본인 마음 표현 하는거지 교회 강요 하지 않습니다 교회 헌금 목사 배속 들어갈것 같나요 장로 들 성도 들 그걸 놔둘까 요 교회 헌금 통해 사 역자 들 먹고살아야하기에 월급 줍니다 돈 더 들어왔 다해 월급 더 받지 않아요	FALSE
남은 돈 요 교회 오는 사람 들 위해 다과 음식 무료 즌 비하구요 일부 교회 전 기세 수 도세 등 유지관리 비 나갑니다 자 그래도 돈 남으면 지역 사회 아동복 센터 외국인 쉼 터등 기부 합니다 기독교 안좋은 면 보고 일반 화 좀 하지 마세요 적어도 미국 기독교 전세계 믿는 오 리지 널 과거 내려오던 진짜 기독교 그딴 짓 안 합니다 기독교 유사한 종교 들 사이비 기독교 혼동 하지 마세요	FALSE
모든 교회 성 지었는데 당연히 전 기세 수 도세 많이 나갈테지 ㅋㅋㅋㅋ 아주 땅 부자 들 십일조 안내면 이상하게 눈치 보이는 그 곳 ㅋㅋㅋ	FALSE
위 호구 하 있네 ㅋㅋㅋㅋㅋ 돈 목사 안 간다고 조용기 아들 재산 얼마 스포츠카 가격 얼마 지나 알아봐라 ㅋㅋㅋㅋ 저렇게 멍청하니 등 빨대 꽂혀도 모르지	FALSE
곳곳 있는 작은 교회 돈 없고 권력 없지만 예수 있습니다	TRUE
전광 후니 보면 교회 다니기 싫다	FALSE
당신 세상 사람과 방송 비판 하는 그 편견 가지 전 목사 님 보고 있습니다 그 분 설교 말씀 너 알 TV 찾아 들어 보시 절대 하나님 뜨겁게 사랑 애국 운동 하시는 것 알 수 있습니다 혹 들어도 모른다면 당신 하나님 잘 모르는 사람 입니다	FALSE
best 당신 어리석은 사람 있으니 하나님 때려 죽인다는 광 후니 하나님 발 이 밥 먹고 사는거요	FALSE
충격 먹은게 전광훈 하나님 나 까불면 다쳐 죽어 하는 거 보고 진짜 이 사람 목사 아니구나 했다	FALSE
근데 전광훈 하는말 이라도 제대로 들은 사람 있냐 ㅋㅋ 어차피 인터넷 기사 보고 욕 하는 수준 ㅋㅋ 지금 광화문 문재인 탄핵 시위 벌이는 유일하다시피 한 단체 왜 계속 그런 기사 나온지 생각 잘 해봐	FALSE
많은 교인 들 성경 아는 방법 모른다 성경 읽어서 알수 없고 온전 말씀 찾아야 약속 지키는 것 무엇 알수 있다	TRUE
한국 교회 이미 구 제 불능 입니다 빤스목사 추종자 들 보세요 건축 헌금 교회 대기업 커가는게 싫어서 교회 안가요 늦었지만 교 제발 정신 좀 차리길	FALSE
암만 애기 해봐야 내 입 아퍼여 냅 둬	FALSE
인간 예수 될 수 없어요 죄 성 때문 그러나 성령 구 예수 닮아가려고 노력 하는 거 겠죠 인간 몸 살며 완벽하지 못 모습 행동 가운데 하나님 자비 구 하며	FALSE
성경 분명하게 예수 외 구원 다른 이름 없다 분명히 말씀 하셨는데 저 양반 구원 길이 다른 종교 있다고 얘기 함 이 것 말로 멸망 들어가는 길	FALSE
천주교 신자 들 종교 인정 하 않지만 존중 한다고 말함 말장난 ㅆㅅㅌㅊ 교황 믿음 없어도 구원 가능하다고 말 하는데	FALSE
종교 원 주의 기독교 아니죠 물론 무신론자 들 더 기독교 가까운 존재 들이긴 하지만 딸기 딸기 일 때 딸기 것임 같은 과일 딸기 수박 되면 딸기 아니죠 마찬가지 님 말씀 기독교 핵심 교리 없어지면 과일 종교 일수 있어도 딸기 기독교 아님 잘 못 된 교리 잘 못 된 부도덕 둘 다 위험함 기독교 안티 더 강력한 사탄 있다면 사탄 무기 임 내부 적 더 쉽게 허물 어 냄	FALSE
어차피 종교 원 주의 뚜렷하기 때문 그다지 위협 되지 않음 오히려 무신론 갈등 유신론 수호 하는데는 이 들 지성 도움 됨 교회 안 부도덕 어디 쓸데도 없다 가장 사악한 사탄 간첩 들 세습 간음 횡령 그 외 등등 등 신앙 자체 허물 어 버림	FALSE
https://blog.naver.com/tldrmffnql 하나님 블로그 하나님 모든 종교 초월 해요 이 우주 모든 걸 만드셨잖아요 이상한 짓 하는 미개한 종교 그동안 이교도 해서 치워 버린 거지 불교 같은 수준 높은 종교 배척 하진 않음 착하고 바르게 살 다 구원 받습니다 예수님 믿는다는 게 그런 의미 임 착하게 산다 사람 해치 않는 성숙한 종교 기독교 아니라는 이유 배척 하지 마세요 그건 잘 믿는 게 아니라 멍청한 거임	TRUE
ㄴ 그런 입장 새로운 종교 일수 있어도 성경 전통 기초 한 기독교 할 수 없죠 카톨릭 공공 연하 형식 적 애기 하 듯 교회 사도 전승 따름 개신교 성경 더 높히지만 간 이어지고 축적 되어 온 핵 식 점 견해 견지함 이 걸 훼파한다 새로운 종교 인정 합니다 기독교 아니죠	FALSE
식점 x 핵심 적 o	TRUE
의미 즉 이 말 달리 이야기 하면 모든 주교 들 사도 들 후계 자 주교 가장 기본 적 직무 근본 말 하는 것 각 주교 들 세상 퍼져있는 지역 교회 교구 들을 사도 후계 자 로서 사목 하며 이 과정 예수 사도 들 가르치고 위임 가르침 들 보전 전수 하는 역할 수행 하는 것 파일 external /www.reclaimingthemind.org/apostolic-succession.gif 이 것 한 교회 예수 가르침 역사 적 올바르게 보전 있는지를 판별 할 수 있는 아주 중요한 척도 동시	FALSE
그냥 옮 말 토달 지말고 받아 드려라 그럼 넌 예수 보았니 성경 말씀 대로 살고는 있니 전광훈 이도 예수 믿는 놈 아니니	FALSE
동시 사도 들 하나 교회 이루었듯이 전체 보편교회 일 원 인지 살펴볼 수 있는 기준 된다 카톨릭 이러하나 이런저런 것 덧붙여서 현재 교황 주교 사도 권 이어 받았으므로 교리 수정 자의 적 가능하다 등 부패 오용 저지르다 개신교 성경 중심 론 타격 받고 스스로 자정작용 하는 등 하였지만 그러니까 말 다르게 함정 있으나 공식 적 카톨릭 표방 하는건 예수 세기 사도 들 가르침 권위 임 그렇기에 궁극 적 카톨릭 전통 수호 하면 종교 원 주의 원리 적 불가능함 전통 위 배되 기 때문	FALSE
그 한국 최초 평신도 교회 새길 교회 창립 멤버 중 한 명 종교개혁 마르틴 루터 핵심 주장 가운데 하나 하나님 아래 모두 평등한 신도 ‘ 만인사제설 사 제 계급 특권 부인 것 평신도 교회 이 뜻 따라 별도 목사 장로 등 두지 않는다 모두 목회자 이자 신도 그렇기에 새길 교회 교회 예배당 담임 목사 목회자 소속 교파 교단 가 없는 이른바 ‘ 무 無 교회	FALSE
사이비 즉 유사하나 아니다 부처 인간 므 누구 번뇌 근원 욕심 버리면 해탈 즉 번뇌 벗어나 성불 한다 부처 되는 것 부처 란 석 가가 다다르고자 한 최고 경지 그래서 법정스님 더 위대한 부처 되십시오 강연 했다 ㅡ 그러나 예수 인간 아닌 하나님 시 하나님 사람 몸 처녀 마리아 통해 신비 탄생 하시고 신이시라 죽음 부활 예언 하신 후 성취 하시고 사십 일간 천국 복음 가르치시다 오백 명 보는 가운데 하늘 산 채 올라가셨다 그 분 생전 숱 기적 만드셨다 인간 그 분 가르침 사는	TRUE
제자 될 수 있어도 스스로 예수 될 수 없다 교묘히 부처 예수님 동격 만든 사탄 적 논리 성철 종 정이 법 어 집 말 했다 부처 곧 사탄 자신 그 부처 존경 한다고 ᆢ	FALSE
딱 맞는말인데 교회 목사 빠져있는것 들은 댓글 나빠요 누르기 바쁘구나 한심한것 들 예수 안 믿고 돈 눈뒤집힌 목사 말 믿는 한심한 인간 들 너무 많다 제발 정신차려라	FALSE
정신 너 차려 남 걱정	FALSE
양심 찔려 발끈 하는 건지 ㅋㅋ 너 잘 하세요 남 걱정 시키지	FALSE
교회 다니시는 분 들 목사 말 믿는다고 당신 바보 ㅂ 니다 그 어느 누구 목사 말 안 믿어요 성경 말씀 믿지 근데 천주교 누구 말 믿어요 교황 믿죠 오류 없다고 미친	FALSE
간만 좋은 기사	TRUE
진짜 어이 없었던건 전광훈 대한민국 망한다고 하나님 들었다고 하자 그 자리 대다수 반박 하지 않았다는 것 보수 진보 정권 잡으면 대한민국 망하는게 좋다고 생각 하는것 아닌가 진보 보수 아무리 의견 달라 나라 망하길 바라면서 상대 저주 하는 집단 되어 버리면 그건 이미 매국	FALSE
“ 누구 예수 되는 것 ” 이 아니라 “ 누구 예수 그리스도 닮아 가는 것 ” 이겠죠 다 맞는 말씀 같은데 앞 뒤 안 맞는 모순 주장 계시네요 앞 예수 성육신 하신 하나님 하시고 뒤 누구 예수 될 수 있다고 하시니 조건 맞으면 누구 성육신 하신 하나님 될 수 있다는 말이잖아요 피조 물이 창조자 됩니까 일단 논리 모순 좀 어떻게	TRUE
옴 마니 반 메 훔	TRUE
주변 기독교인 들 보면 기독교 자체 무속신앙 섬기듯 하더라	FALSE
길 희 성 엉터리 생각 갖고 있다 그럴듯한 비판 기독교 본질 벗어난 자신 사상 설파 있다 인간 하나님 되어야 한다고 요한 완전히 거짓 해석 했다 대형 교회 폐해 있지만 대형 교회 그 자체 나쁜 것 아니고 자연 형성 된다 세속화 기독교 정당 무슨 관계 있는가 독일 등 전세 기독교 정당 많다 미국 사실 상 기독교 정당 들 목사 시키는대로 하지 말 영성 스스로 찾는 것 이 공동체 질서 목표 방향 있다 당연히 지도자 지도 필요하고 따르는 것 구성원 모습	FALSE
형아 아주 평범한 애기 하나 해줄께 진정한 기독교인 신도 님 들이야 먹사 당 연희 사 깃 꾼 예수 형님 언제 십일조 가져오라 했나 그리고 구약 미신 여오아는 자기말안 들으면 벌준다고 엄청 사기치 잔어 그거 제사장 말 하자면 목사 들 만든거야 예수 형님 언제 벌준다고 하는것 받어	FALSE
전광훈 아들	TRUE
교회 장로 로써 한 마디 교회 가려면 내 열 손가락 장 지지겠다 면서 동창 들 전도 그토록 대적 했던 나 전 나 개독교 먹사 서양 귀신 등등 나 입 붙어 다니는 단어였고 종교 다 같은 건데 꼭 교회 가야 구원 받는다는 게 말 되냐면서 소신 살았던 나다 교회 비리 신 문 기사 나오면 거 봐라 라면서 더욱 스스로 합리화 했다 집안 가르침 올 곧 살 되는 거지 교회 왜 필요한 건데 했던 나 성경 가장 무서운 말씀 믿음 모든 사람 것 아니니라	FALSE
ㄴ 그래서 믿음 당신 거가 되었나요 교회 이쁜 여자 보연 이쁘 네 침 닦은 적 없나요 교회 주는 식사 시간 맛있는거 더 먹고싶지 않았나요 장로 님 왜 장로 되셨어요 이야기 더 듣고 싶습니다	FALSE
뭔 개 소리 자기 합리화	FALSE
답글 보면 불신 자 들 공통점 보인다 글 자체 너무 예의 바르고 겸손하다	TRUE
불교 불성 사상 비슷하다에 거르 갑니다 불성 사상 자체 나 노력 나 자신 구원 하다인데 값 없이 주어지는 구원 은혜 비슷하다 뇨 크리스천 아닌 신학 자이시 군	TRUE
목사 자식 들 하나같이 유학 중 그 중 정말 공부 할려고 나간 애 들 몇 될까 싶다 종교 단체 특히 교회 세금 걷자	FALSE
참 교인 진정 예수님 말씀 살려고 노력 하시는 분 생각 듭니 근데 광신도 들 이 분 보고 이단 하겠지요 한국 기독교 참 모순 된게 많습니다 파 나누고 또 본인 다니는 교회 아니면 또 배척 합니다 종교인 보다 자기 중심 적 사고 빠져서 종교 명분 타인 상처 주는 나르시시스트 들 같습니다 한마디 정신 병자 들	FALSE
교회 왜 가는지 이해 안 간다 미국 유럽 교회 들 다 들 문 닫는 공동 화 현상 일어나고 있다 교회 신앙 후진국 열 올린다 대한민국 교회 들 솔직히 돈 벌려고 하는 것 아닌가 다 들 대형화 관심 있고 부동산 투기 열 올 리 있다 교회 다니는 사람 들 이해 안 간다 교회 헌금 할 돈 있으면 불우한 이웃 돕는 것 낫다 교회 가져다 주어 봤자 전광훈 같은이만 좋을 뿐	FALSE
왜 이 해안가 머리 나쁘네 그러니 나라 이 모 냥 헬 조선 유권자 들 대부분 머리 나쁘니 ㅋㅋㅋㅋㅋㅋ 대형 교회 나가야 인맥 생겨서 서로 끌어주고 밀어줄거아냐 ㅋㅋㅋ 거액 헌금 후원 해주고 명박 이 서울시장 되 기전 교회 장로 새벽 주차 요원 하는거 못 봤냐 ㅎㅎㅎ	FALSE
참으로 한심한 교수 시 성탄 기쁨 함께 나누자고 하면 될텐데 교회 목사 욕 하면서 분열 조장 하는건 뭐임 교황 신부 추기경 천주교 인 문재인 욕 좀 같이 해 주시 좋았을것을 마치 교회 목사 문제 있는 것 말씀 하시면 안 돼요 서강대 교수 이 시 천주교 듯 한데 아님 신부 님	FALSE
이런 개똥 철학 어디서	FALSE
담임 목사 하나님 떠받 드는 거좀 하지 맙시	FALSE
저 교회 다니게 되면서 교수 님 비슷한 생각 하게 되었어요 형식 적 종교 생활 실 생활 성경 가르침 살아가려고 노력 하는게 맞다는 걸	FALSE
교인 들 문제 크다 믿음 있어서 하나님 섬기는것이 아니고 선거 위해 사업 위해 인맥 위해 명예 위해 대형 교회 나가고 그 목회자 옳지 않다는걸 알고도 주류 흐름 따라 휘 둘리 그건 믿음 아니고 신 대한 배신 그런 인간 간사함을 잘 이용 하는 목회자 들 바로 대한민국 교회 추악함을 보여주는 그 들 신은 당신 마음속 있다 목회자 옳은 길 가지 못 한다면 가차 없이 비판 할줄 알아야 진정한 믿음 당신 눈 마음 가린 자가 진정 목회자 악마 구분 하	FALSE
정답 목사 들 물어보고 싶다 신앙심 깊지만 돈 없어 헌금 못 하는 신도 신앙심 잿밥 관심 더 많지만 헌금 많이 하는 신도 당신 선택 단번 대답 못 하겠지 이 인간 종교 한계	FALSE
혼자 판단 하는 그대 또한 누군가 판단 받겠군요	FALSE
지극히 지당 하신 말씀 교회 목사 물질 눈독 있지 진실 양심 없고 보인다	FALSE
권위 쩐 내려놀 목사 몇 명 될까 성 전 건축 ㆍ 리 모델링 추진 하면서 딸 이 장로 권사 업자 짜 고공 사비 부풀려 수천 만원 ㆍ 수 억 씩 한몫 챙겨야 되쥬	FALSE
교회 상처 입어 본 사람 라면 극 공감 할 것 같습니다	FALSE
제대로 된 신학 했으면 저런 헛소리 안 하겠지요	FALSE
제대로 된 신학 배우고 실천 했어도 세습 간음 횡령 안 함	FALSE
좌빨 들 는 종교 하나 수단 이 사회 혼란 하게 만드는	FALSE
너희 불의 행 속이는구나 그 너희 형제 불의 자가 하나님 나라 유업 받지 못 할 줄 알 못 하느냐 미혹 받지 말라 음행 하는 자 우상 숭배 하는 자 간음 하는 자 탐색 하는 자 남색 하는 자 도적 탐욕 부리는 자 술 취하 자 모욕 하는 자 속여 빼앗는 자 들 하나님 나라 유업 받지 못 하리 미혹 받은 자칭 제대로 된 신학 간음 자 신의 것 도적 질 세습 횡령 자 지옥 진짜 신학자 사도 바울 말씀 하 심 성경 깔끔히 부정 하는 교회 안 사탄 개 먹 들	FALSE
원래 예수 사회주의 자임 ㅎ	FALSE
근데 사회주의 자 집 너무 크네 투자 잘 했구먼 ㅎㅎ	FALSE
같은 영혼 존재 태어났으나 그 중심 어리석어 심판 죽음 향 해 달려가는 인간 들 나 영혼 괴롭게 하도다 어찌 그리 어리석을꼬 인간 예수 닮아가는 것 결코 예수 될 수 없다 존재 하는 영혼 신 생명 부여 받은 인간 들 창조주 모르는 것 진리 모른다는 것 그 진리 곧 예수 이 시 그 보이지 아니하시는 창조주 하나님 실체 이 시 인간 죄 대신 하여 죽음 택 하신 사실 믿지 않는 모든 영혼 들 둘째 사망 심판 받게 될 것 어리 석도 인간 들	FALSE
제 볼 적 당신 어리석은 것 같은데	FALSE
예수님 구원 믿어야 진짜 그리스도인	TRUE
개 궁금한게 예수 생전 신도 들 돈 커녕 먹을게 없어서 빵 한 조각 겨우 나눠 먹고 그랬다던데 돈 받치는 적폐 행위 어서 생긴거 임	FALSE
교회 믿는 것 들 믿고 걸러 무조건	FALSE
오오 보기 드문 참된 개신교 인 진정한 프로테스탄트 인정 합니다	FALSE
이런 제대로 된 생각 말 들 가득한 세상 되어야 하는데	FALSE
개신교 개혁 대해 서는 공감 하는 바이 인간 본질 피조 물 로서 자신 노력 성찰 통 하여 신 될수있다는 사고 기독교 본질 괴리감 생겨 경계 해야 할것 임	FALSE
하나님 이름 팔 사리 사욕 챙기는 그 직업 먹사 성범죄 부동 위 직업 먹사 세금 안내 얼마나 좋으면 김정은 처럼 새습하고 미치것다	FALSE
아이고 성 님 하나님 이십 니	TRUE
그래도 교회 세상 빛과 소금 역활 하고 있습니다	FALSE
현재 우리나라 서는 개신교 전혀 아니라 봄	FALSE
교회 필요없다 이런 사도 바울 저런 얘길 들었다면 어땠을까	FALSE
사도 바울 저런 얘기 들었으면 맞는 말 하겠지 틀 딱	FALSE
사도 바울 지금 한국 교회 보면 통곡 한다	FALSE
교회 존재 이유 부정 하는 발언 반성 서적 입니다 한국 교회 다 문제 있고 다 대형화 되어있다고 일반 화 시키지 마세요	FALSE
ㅋㅋㅋㅋ 누가 보면 그리스도인 인줄 부처 되세요	FALSE
전광훈 같은 사람 보수 이유 보수 자체 그런 비 논리 받아주기 때문 진보 그런 말 하면 거리 두 거나 적어도 진보 인정 하지 않는다 그런데 보수 전광훈 대한민국 망한다는 하나님 말 들었다고 해도 그냥 좋아한다	FALSE
보수 아니란 거 후 져서 그러고 들 있으니	FALSE
예수님 현대 나타나신다면 아마 가장 먼저 한국 대기업 교회 들 강도 들 소굴 하시면서 다 때려 부수 일 하실 것 성경 나오는 장사치 성전 다를게 있다고 생각 하냐	FALSE
내 안 예수 나 신성 찾아라 기독교 아니네요 기독교인 기독교인 교 비 기독교인 기독교 인 통찰 비판 있지만 기독교 인체 하 비 기독교인 아닌 모호한 판단 좀 그러네요	FALSE
대다수 신자 들 전광훈 목사 같은 사람 따르는게 현실 한기총 회장 아무나 되는게 아니다	FALSE
먹 사는 그냥 돈벌이 직업 하나	FALSE
좋은 말씀 전광훈 목사 아닌 사이비 사기꾼	FALSE
스스로 하나님 가야 합니다 교회 목사 이 우주 존재 하지 않습니다 하나님 같이 생각 행동 할 때 하나님 갈수있습니다 하나님 절대 교회 목사 같은 중간자 만들지 않았습니다 그 들 위선 자 들 입니다 깨달음 위 험난한 고통 이겨내고 스스로 다시 태어나려 하는 자만 하나님 곁 갈수있습니다 지금 모든 교회 그 관계자 들 인간 욕망 만들어 낸 모두 가짜 허상 입니다	FALSE
스스로 갈 수 있다고 보는 모야 이군 다른 이로 서는 구원 얻을수 없다고 성경 가르칩니다 천하 인간 구원 할 다른 이름 주 신일 없다고 말씀 합니다 그래서 은혜 입니다 죄인 스스로 하나님 나아갈 수 있는 방법 없습니다 그러나 천주교 선 한일 하면 천만 말씀 의인 없나니 하나 없고 선 행 하는 자도 없다고 성경 가느 칩니다 목사 말 믿지 않아도 되요 그러나 목사 입 나오는 말 일지 하나님 말씀 전하 것 이 믿어야겠지요	FALSE
기독교 불교도 구분 못 하냐	FALSE
한국 개신교 성경 자체 이상하게 싸져서 교회 나가지 않으면 일단 이단 거나 하나님 진심 섬기지 않는다고 전 제한 뒤 설교 시작 다 하나님 믿는 믿음 전제 교회 나가는건데 근데 교회 나가면 하나님 위 목사 있는걸 보면서도 멍청하게 그 목사 따른다 한국 개신교 그 자체 거대한 이단 사탄 고칠 방법 없다	FALSE
한국 교회 고쳐야 할 점 많지만 저 교수 인간 예수 될 수 있다는 발언 천벌 받을 발언	FALSE
지금 세기 G 시대 입니다 그나마 깨어있는 학자 네 다 밥그릇 채울려고 횡설수설 하는데요	FALSE
교회 가 본적 없는 분 들 자꾸 교회 욕 하는 게 너무 웃기네요 기독교 목사 교회 충성 하는 종교 아닙니다 그리고 대한민국 국민 누구 자기 맘대로 교회 선택 할 수도 있구요 목사 선택 할 수도 있거든요 또한 불교도 대승불교 부처님 절대 적 신 여겨집니다 우리나라 대승불교 나라구요 왜 자꾸 소승불교 극 소수 땡 중이 헛소리 다는지 모르겠네요 기독교 불교 올바로 알고서 댓글 다시기 바랍니다 아무 것 모르고 아무 말 대 잔치 만 하네	FALSE
자기 옳다는 기독교 정신 아주 못 박혀있는 사람 내 눈 부처 예수 중 들 먹 사들이 사기치는것으로 안보	FALSE
뭔 소리 이 신지 전 기독교인 아니구요 종교학자 입니다	TRUE
예수 인물 제자 중 도마 가 있는데 이 사람 인도 선교 하였고 그 가르침 불교 녹아 들어가서 대승불교 를 만들었다고 봐야 하 거든요 물론 소승 믿는 당신 모르겠지만 아주 그냥 수준 낮으시네요	FALSE
참나 땡 중 똑같이 말 하네 말세 오니 더욱 모이는데 힘쓰라 는 성경 말씀 중 가장 중요한 핵심 너 모르는 구나 수준 낮다 여기 기독교 비난 하는 댓글 다는 것 들 대부분 땡 중 알바 들이랍니다 참으로 수준 들 낮지요 참고 문재인 정부 에 절 을 국민 세금 주고 있다는 거 아시는지 모르겠네요 지금 절 국민 세금 지탱 하는 중임	FALSE
퍼 동의 후륭 하신 성찰 입니다 하지만 마지막 말 도믜할수 없네요 인간 예수님 정신 따라 살아야 함 당연하고 추구 해야 할 일이 인간 예수님 될수있다는 말 잘 못 되었네요 좋은 말씀 하시는 분 들 존경 하는데 꼭 끝 득도 말씀 하시는 말씀 틀렸네요	TRUE
이분 걍 자연인 뫼 시 길 방송출연 함하시오 자연인 ㅋ 혼자 세상 사상 빠져서 헛소리 하시니 자연인 딱 적합함	FALSE
이 좋은 글 고요 자신 천국 안가면서 다른 사람 천국 못 가게 하는 소리 들립니다	FALSE
이런 식 전광훈 목사 님 까는구나 그러니 간 기사 써줬겠지 분별 잘해야 되는 시대 왔다	FALSE
전광훈 목사 이 푸훗	TRUE
예수님 하나님 동등 됨을 취할 것 여기 않으시고 이 땅 오심 기념 하는 날 전혀 어울리지 않는 기사 진정 예수 되려 하는가	FALSE
요즘 종교 원 주의 사상 듣기 좋고 무난 말 하는 사람 들 아주 많아졌다 그래서 안 그래도 교회 안 나가는 들에게 마음 편안함 주고 스스로 옳다고 여기는 담대함 마저 준다 종교 어떤 종교 다 같다는 신념 갖게 한다 무지한 신념 무지하다고 깨닫기까지는 평생 보낼 수도 있다	FALSE
신 있다는 증거 있어	TRUE
다 맞는거 같아도 중요한 핵심 즉 끝 다르면 이단 단 끝단 자거든 신천지 각종 사이비 종교 집단 얘기 들어 보면 처음 그럴 싸 한데 갈수록 이상해지고 근본 잘 못 되어 있음 사람 신 될수 없어 그러니 죽는거고 한계 명백한거지	FALSE
좌파 언론 들 원하는 딱 한가지 개신교 멸절 말 안되는말로 국민 현혹 할려 구 난리	FALSE
당신 잘 해라	TRUE
맞아요 성도 들 목사 들 참되신 어린 양 자녀 입니다 다 똑같은데 신학 공부 했다는 이유 무지하게 보지 마세요 저희 설교 초등학생 들 가르치는 식인 아닌지 다 판단 할 수 있거든요	FALSE
니 무슨 목사 목 사라 밥 먹고사는거지	FALSE
이런 인간 들 때문 진짜 교역 자 들이 욕 바가지 먹고있지 ㅉㅉ	FALSE
어제 오늘 저 내 안 선한것은 하나 없다는걸 깨닫고 철저히 부서졌습니다 뭐 되는것처럼 일장 남 설교 잔소리 해대 저 교만 보고선 역겨웠습니다 그토록 타인 잣 재고 평가 하는 교만 경계 했건만 어느새 제 마음 높은 도덕 윤리 추구 있었습니다 사도 바울 나 날 죽노라 를 읊조려 봅니다 저 결코 선하지 않으며 예수님 될 수도 없습니다 단지 주님 사로잡혀 남은 인생 주님 뜻대로 순종 할 수 있길 간절히 원하는 작고 낮은 사람 되고 싶습니다	FALSE
좌빨 집회 앞장서는 새끼 들 부터 좀 때려 잡아주 슈 그게 종교인 빨갱이 깡패 새끼 들	FALSE
틀린말은 없는것 같다 개신교 목사 들 이글 읽고 느끼 는바 조금 있기를 바 본다	TRUE
그 놈 헌금 강요 어디 나오는 말 누가 만들어 낸 말 요즈음 교회 헌금 강요 한다고 교회 다니면서 하시는 말씀 들	FALSE
목사 예 수 팔 돈버 직업 아님 ㅋㅋㅋㅋ 무슨 목회자 개뿔 개신교 제일 싫다 진짜 물욕 추구 하는 예수 쟁이 들임	FALSE
내 안 있는 걸 모르고 교회 가서 목사 찾는 어리석은 자 들 그래서 개독교 소리 듣는 것임	FALSE
진짜 맞는말 같은데 내 안 예수 찾으라 대체 교회 가서 돈 내는 이유 머 그리고 전도 해서 얻는게 돈 아닌가 피라미드 그 돈 건물 짓고 사고 세금 푼안내고 개 ㅅㅐ 들	FALSE
개 백정 목사 있던데여	FALSE
한국 교회 사학 비리 차이 없는거 같다	FALSE
마치 목사 자기 하나님 마냥 떠들고 결론 내는 설교 사기꾼 오늘 길 교수 님 말씀 감동 입니다	FALSE
심신 이미 약할 때 보이지 않는것에 기댈 때 심리 이용 하여 마음 빼는 그야말로 사탄 악마 같은게 인간 들 아닌가싶다 그 걸이 용해서 이득 취하 그런 인간 병들게 하고 의지 약한 본인 탓 해야 한다 험 한세상 사람 상처 받은건 아이러니 하게 사람 치유 된다 피 하지말고 치유 해라	FALSE
목사 집 자가용 보면 대충 답 나온다 ㅋㅋㅋㅋㅋ	TRUE
아멘 이분 예수 이 시 할렐루야 무종교 이분 말씀 완존 동감 입니다	TRUE
이 분 철학 부처 성불 개념 누구 도를 닦으면 부처 될 수 있다 기독교 그래서 불교 조금 덜 더럽지	FALSE
정치 민주화 경제 민주화 종교 민주화 이루어지길 권력 정점 누구 타락한다 수많은 불교 종파 교회 통일교 신천지 등 권력 정점 사욕 빠져 타락 들 하셨다 종교 내 안 하느님 찾는것 종교 수장 권력 견제 분권 개인 소유 하지 못 하게 해야 그 들 타락하지 않음	FALSE
맞는 말씀 교회 목사 들 사기꾼 들 대부분 임 스스로 믿는 종교 찾아라	FALSE
배웠다는 분 위험한 생각 가지 계시 여러 교단 종교 짬뽕 하 듯 좋은 지식 섞어놓으면 하나 사상 된다는 이런 행보 보이는 분 들 대부분 교수 들 많던데한 종교 까는 짓은 하지마라 너 믿음 너 것 다른 사람 믿음 편향 되게 가르치려고 드는 것 영락 없는 사이비 안보	FALSE
전광훈 목사 님 헌금 사유화 하지 않았고 애국 운동 하는데 사용 합니다 전 목사 님 하나님 만나고 개월 시골 가서 전도 말씀 전하 병자 고치 교회 세우셨습니다 신학생 때 평 아파트 팔아서 가난한 사람 들 다 나누어 주셨습니다 너 알 TV 찾아 들어 보세요 말씀 들으면 참 목자 것 알 수 있습니다 지금 애국 집회 나라 위태 로우 하시는 것 입니다	FALSE
참어 찌그리 순진할까 그러니까 광훈이 헤메 는거야	FALSE
이런 작자 들 때문 이단 생기는거다 만인 예 수다 한다면 만인 부처 될수있다고 하는 불교 가면 될것 아닌가	FALSE
모처럼 존경 할만 한 분 나타나셨다	TRUE
이 양반 시작 좋았으나 위험하네	FALSE
현 교회 목사 들 잘 하고 있다는건 아니다 그러나 법복 입은 사람 할 말 아닌것 같다 뿐 아니라 내 안 예수 운운하는데 그 또한 할말은 아닌듯	FALSE
도대체 교회 가서 목사 헌금 하는게 예수님 무슨 관계 있나 집 성경 읽고 일 일 일선 하는게 천당 가기 쉽겠다	FALSE
이스라엘 왕 태어나셨다 그런데 유태인 유대교 믿으며 예수 메시아 생각 하지 않는다 그 들 인정 하지 않거늘 다른 민족 인정 하는 아이러니 웃기는 짬뽕	FALSE
믿지 않는것이 아니고 예수님 메시아 이심 믿고싶지 않은거겠죠 당신 마찬가지 고요	FALSE
자기 아버지 자식 믿지 않는데 옆집 애 들 믿는 꼴 정상	FALSE
넌 글 읽을 줄 모르나 목회자 이 단 논리 중독 된 불쌍한 교인	FALSE
기독교 양은 먹이 살찌워 서는 도살 해서 그 고기 먹고 가죽 신발 만드는데 쓰는 순수한 재산 의미 양 귀여워서 풀 먹이 돌보는 목자 이 세상 없다 목자 양은 미래 고기 재료 일 뿐	FALSE
혹시 도살 하는 일 하시나 봐요 ㅋㅋㅋㅋㅋㅋㅋㅋㅋㅋ 야 댓글 수준 아주 그냥 ㅋㅋㅋㅋㅋㅋ 그렇게 헌금 내기 싫으시면 큰 교회 다니면 되는데 대형 교회 헌금 안내 사람 많거든요	FALSE
실제 양치 목자 순한국말 양치기 직접 양 도살 해서 부위 별로 해체 하는 걸 우연히 본 적 있음 그 들 목자 양은 고 기일 뿐	FALSE
지역구 세습 하는 문희상 있는데 ㅎㅎㅎ	FALSE
두 가지 다 필요한거지 어느 한쪽 치우치는건 아닌것 같은데요 은혜 없는 묵 사도 많지만 마음 하나님 깨 향 하게 해주는 훌륭하신 목사 님 계세	TRUE
휼륭하고 그럴듯한 궤변 잘 들었습니다	FALSE
길 희 성 뭐 자기 중심 생각 똘똘뭉쳤 쯧쯧	FALSE
이런 목사 님 있는 반면 하느님 자기 까불면 혼난다고 하는 빤스 목사 샛기 있지 ㅋㅋ	FALSE
각자 맞게 지어진 하나님 피조 물 우리 모두 알아야 할 사실 우리 언제 죽을지 오늘 당장 죽을지 내일 죽을지 모릅니다 예수님 탄생 하신 이후 A D Anno Domini 신의 나이 을 통 해서도 그 누구 하지 못 부활 통 해서도 불교 이슬람교 등등 이단 없지만 저희 JMS 신천지 여호와 증인 하나님 교회 등등 이단 많다는 것 통 해서도 예수님 믿는 신앙 종교 아닌 유일한 진리 임 알 수 있습니다	TRUE
기독교 서양 종교 일 뿐 말씀 하시는 분 들 계신데요 일단 저희 믿는 신앙 종교 아니라 유일한 진리 이구 예수님 이스라엘 태어나시고 성경 이야기 유대 지역 공간 적 배경 이루어진 건 어쩔 수 없이 한 곳 역사 이루어져 야했기 떄문 대신 예수님 땅끝 세계 만민 복음 전하 하신 걸 보아 그리스도 믿는 삶은 서 양 종교 아니라 전 세계 알아야 하는 유일한 진리 임 알 수 있어요	TRUE
또한 복음 들어오지 않은 시대 조상 님 들은 다 지옥 갔냐고 하시는 분 들 계신데요 복음 전해지지 않는 지역 사람 들 그 양심 따라 심판 받는다고 성경 나와요 세기 복음 전해진 건 그 당시 교통 수단 발달 하지 않았기 때문 이 또한 악 존재 하는 이유 요 아담 하와 이후 잠시 마귀 지배 하는 세상 되었어요 마귀 공중 권세 잡은 자가 된거 하지만 예수님 다시 오시 그날 마귀 영원히 꺼지지 않는 지옥불 영원히 울며 이를 갈게 될 것 하나님 예수님 다시 통치 하실 거	FALSE
또한 하나님 믿지 않는 자 들 지옥 보낼 정도 나쁜 신 아닐 거 분 들 계신데요 중요한 본질 요 하나님 지옥 만든 원래 목적 공 의 따라 타락한 천사 들 영원히 벌주기 위 함이었습니다 하지만 아담 하와 선악과 사건 이후 이 세상 주관 자 마귀 되었고 그럼으로서 악한 일 들 여기저기 벌어짐과 동시 사탄 마귀 들 인간 들 유혹 해서 지옥 끌 갈 수 있는 권한 가지 되었습니다	FALSE
혹 나 위 사실 들 믿기 어려우시다면 하나님 하나님 실재 존재 하시다면 저 알려주세요 기도 하시는 걸 추천 드려요 저희 하나님 실존 하 심 유일한 진리 이심 천국 지옥 실재 함 알 아직 믿지 않으시는 분 들 모르시는 게 당연하니까 요 여러분 입장 기도 하여 알아내는 것 밑 져야 본 전일 뿐 아니라 실제 죽은 후 천국 지옥 있어서 믿지 않아 지옥 간다 그 땐 후회 해도 나갈 수도 되돌릴 수도 없기에 아무런 소용 없으니까 요	TRUE
추천 유튜브 채널 하나님 음성 사모 하는 사람 들 추천 네이버 블로그 이 세대 가기 전 추천 책 하나님 대사 김하중 장로 님 하나님 각자 맞게 창조 하신 피조 물 여러분 사람 들 대우받기 위함 아닌 하나님 찬양 하기 위해 지음 받으신 이사야 여러분 읽어주셔서 감사해요 종교 덫 빠지는 대신 우리 모두 천국 소망 안 하나님 동행 하며 거듭 삶 살다가 천국 만나요	FALSE
죽을걸 아니까 먹지 말 한 거지 바보 그걸 무시 따 먹은거고 바로 당신 들 하지말라는 것 주 구 장창 하면서 다른 사람 욕 성경 내용 모르면서 누가 한마디 하면 개때 처럼 달려들어 옳고 그름 판단 하지 않고 비판 하 모 지리 티 팍팍 내는 그런 인간 들 죽어라 말 안 듣는 놈 제 멋대로 살다가 용서 하시는 사랑 생각 못 예측 하지 못 했느냐 하나님 욕 하는 분들 부모님 말씀 드럽게 안 듣죠 부모님 당신 들 행동 생각 모르나요 자기 뱃속 난 자식 속도 모른다고 부모 욕 하면 뭐라고 하죠 불효자 식	FALSE
목사 말 듣는것 들은 기독교인 아닙니다 사방 개목 천지 세습 천지 사탄 들 그 들이지요	FALSE
대형 교회 다니는 노예 들 노예 둔으로 놀고 먹는 사기꾼 들 너무 많다 하나님 큰 교회 보면 얼마나 부끄러울까 ㅉㅉㅉ	FALSE
저건 불교 교리 잖아 깨달음 얻어 부처 되자는	TRUE
교회 가고싶다가도 전광훈 목사 보면 가기 싫다 ㅜㅜ	FALSE
사람 하나님 될 수 잇다 하긴 전광훈 이 하나님 친구 성령 받고 기름 부음 받고 혼내기도 하는 아주 친한 친구 전광훈 만세 할렐루야 끓는 기름 확 부어주고 싶어지네	FALSE
이상하게 스스로 예수 찾는다 ㅋㅋㅋ 스스로 해탈 하는 불교사상 요 ㅋㅋㅋㅋ	TRUE
진짜 여기저기 자기 말 들 맞다 다른 데 이상한데다 그러고 있고 강요 시키고 그냥 원하는데로 놔 누 좋겠다	FALSE
당신 들 신학자 들 묶어놓은 예수 풀어주시요	FALSE
성서 제대로 알 못 하면 타락한 지식인 목회자 나온다 또한 인간 이외 거나 종교 원 주의 관대한 포용 주의자 착각 한다 세습 제 헌금 탐욕 너 나나 모두 있는 인간 죄 문제 비판 받아 부당하다 그러나 이상 미 자립 교회 현실 종교개혁 정신 나아가야 한다 하지만 길 희 성 교수 생각 잘 못 된 생각 가르침 타락한 기독교 가르침 정신차리자 분별 해라	FALSE
아기 예수님 탄생 축하 합니다 저 방금 성탄 미사 끝내고 집 왔습니다 온 세상 아기 예수님 사랑 은총 한량 없이 내려 주소	TRUE
모든 분들 Marry Christmas	TRUE
김대중 골로 보낸 회사 좌파 기업 돈 뜯어 먹으면서 잘 되는 꼴은 못 보는 양면 성 있쥬	FALSE
그렇게 비젼 큰 인물 기업 키워가는데 설사 좀 모험 한 다쳐도 나라 지지 하지는 못 해도 앞서서 해체 하진 말았어야지 대기업 갖고 정치인 들 장난 좀치지마라 역대 매국노 들 따로 없다 기준 안 맞게 기업 하면 규정 따라 벌금 부과 하면 될 걸 갖고 놀지말라고 하여간 김대중 이후 나라 되는 일이 없다	FALSE
옴 붙어서 그래요 김대중 이 국민 갈등 유발 자였죠 특히 경상도 전라도 역사 역적	FALSE
기업 갖고 장난 치 말 자	FALSE
그런 식 따진다면 강만수 김기춘 제일 문제 그 들 인하여 IMF 가 왔고 어찌 되었던 몇 개 큰 회사 들 날려야 할 상황 만들었던 인물 들 강만수 김기춘 최 순 실 아비 같은 사람 들 슨상님 대통령 안될줄 알 있던 이 권력 굽실 되었던 대우 쌍용 등 타겟 되어 대우 공중 분해 되었지만 만약 후임 되었다면 현대 삼성 그 타깃 되었을거 임 그렇게 만들어놓고 좋다고 미국 박사 받으러 간 강만수 자숙 있던 김기춘 MB 와 근 혜시 대 장로 친분 맺어 경제 전문가 라며 기어나와 외환 론스타 헐값 매각 등 일으킴	FALSE
김영삼 이 가장 큰 문제 아지 그런데 죽으니까 영웅 되네 김대중 IMF 극복 공 신인 줄 모르겠고 대우 해체 안타깝네	FALSE
ㅋㅋ 극복 아주 정신 어디 프로 영 감 떨어진 인간 들 있는 법	FALSE
슨상님 소 릴 하는거 보니 ㅉㅉ 불쌍한 거기 구 랴	FALSE
지금 대우 살아있었다면 지금 우린 불 시대 살 있을듯	TRUE
아엠에푸 왓을때 그룹 사정 봣	FALSE
그러게 공적자금 얼마나 쳐 들어갔는데 저런 개 소리 할까 회사 살리라고 투입 그 공적자금 빼 돌린게 누 군 아냐 왜 추징 금 몇 조인 아냐 모자란 새 꺄	FALSE
김우중 회장 저서 세상 넓고 할 일 많다를 읽어 보세요 김대중 대통령 아니었다면 삼성 더 큰 기업 일구고 나라 민족 울 위해 멋지게 쓰임 받았을텐데 너무 안타깝네요	FALSE
저 대 해외 근무 하 그 책 들고 가서 몇번 읽었는데 ‥ 정치가 기업 조정 하는 일 없어지길 바 봅니다 ‥ 고인 명복 빕니다	TRUE
김대중 대우 해체 했다 기업 사유화 시작 이었다	FALSE
Imf 전 부실 기업 인수 해서 방만한 경 영 탓 있음 Imf 시절 김대중 탓 하기는 아닌듯	FALSE
베트남 우즈벡 가보세여 김우중 신입 니 자기 나라 먹고살게 해줬다고 기업 다 들 이민 가세 미국 돈 있는 기업 트럼프 두 팔 벌려 환영 한다 했죠	TRUE
평생 거짓 살아간 김댜중 이름 윤 대중 제갈 대중 김대중 중 편리한 이름 사용 하던 본인 목포 해상 방위 군 현역 출신 이라지만 그런 조직 군 편제 상 없었다고 국방부 밝힘 젊름발 행세 어느 날 왼쪽 또 어느 날 오른쪽 절 다가 나중 지도 기억 못 함 ㅋㅋㅋ 노벨상 한번 받겠다고 수십조 북한 쏟아붇 하던말 북 핵 개발 할 의지 능력 없습니다 북 핵 개발 하면 제 책임지겠습니다 ㅋㅋㅋㅋㅋ 책임 같은 소리 있네 모든 책임 이명박 뒤집어 씌움 라이 이딴 게 전라도 영웅 ㅋㅋㅋㅋ	FALSE
김홍신 너무 거짓말 많이 한다 옛말 염라대왕 거짓말 많이 한 사람 입 봉 한다고 했는데 공업 용 미싱 필요할 것 같다	FALSE
전라도 태생 답 살다 갔구먼 ㅋㅋㅋㅋㅋㅋㅋㅋㅋㅋㅋㅋ	FALSE
대한민국 말아먹은 사람 그 당시 온갖 비난 욕설 하던 사람 들 조문 가는 대한민국 오늘날 부유 견인 했던 많지 않은 사람 들 중 한 분 이었는데 씁쓸한 뒷맛 남기는 이중인격 자 들	FALSE
슨상님 이 꼴 보기 싫다고 하셨어 슨상님 이 꼴 보기 싫다고 하셨어 야 이야이야 그렇게 살다가고	FALSE
회장 님 저 세상 슨생님 뵙거든 부디 주탱 후려 갈겨 주셨으면 좋겠군	FALSE
거 시 기도 확 뽑아 정일 이 받은 개 줘야지	FALSE
겉 천주교 신자 김대중 이 대우 심한 몹쓸 짓 해서 스님 들 위로 해주러 오셨군요	TRUE
아까운 기업인 떠나가셨군요 평생 돈 한 푼 못 벌어 본 놈 애국자 잡았어요	TRUE
종교 이레 야한다	TRUE
진짜 대우 해체 어그 슨상 스 퍼질에 이나라 경제 성장 막은 대표 적 사례 진짜 이제 서야 김 회장 님 먼저 간 그 사람 찿 아가서 분 삭히시길 바랍니다	FALSE
경복궁 맞은편 있는 그 절 이군 크지 않은 규모 조용해서 참선 기도 드리기 좋은 곳 이었습니다	TRUE
김우중 유명한 일화 남겼지 기술 개발 왜 하나 돈 주고 사면 되지 기술 첨단 타령 하지마라 우리나라 선진국 경쟁 해서 이겨 본적 있나 반면 이건희 죽으나 사나 우리나라 기술 개 발해 야한다 선진국 경쟁 해서 이겨 야한다 결국 삼성 세계 최고 됐고 대우 분식회계 사기 쳐 먹고 망했지	TRUE
때 중이 우중 이 자기 정부 욕 한다고 골로 보낸 ㅋㅋ 전라 것 들 상종 하면 안된다	FALSE
대우 르망 차 고장 없이 잘 탓 는데 그때 차가 유선형 현대 깍두기 차보 디자인 우수했었지 그 시절 그립구나	FALSE
부디 평온한 영 하시고 이세 상 우여곡절 파란만장한 삶 무게 내려 놓으시고 먼저 떠난 아드님 만나 멋진 웃음 지으며 만나세요 이 세상 삶 충분히 애 쓰시 모든 힘 쏟으셨습니다 평화 빕니다	TRUE
아깝다 대우 안타깝다 한국 미래 암울하다 부디 극 낙 왕생 하 소서	TRUE
진짜 종교인 들이네요 전광훈 가짜 이단 목사 났네	FALSE
먼 놈 무슨 범죄자 무슨 영 웅취 급하냐 신화 개뿔 분식회계 거짓 영광 뻥튀기 결국 거품 터져서 국민 혈세 몇십 조 꼴아 박게 만든 원흉 추징 금 안내 나가리 은닉 자 산들 가지 그 밑 자식 들 호위 호식 하는데 뭔	FALSE
있는 자가 절 가면 버선 발 튀어 나와 맞이 하지만 서민이 가면 언제 봤나 하는 것 인지상정	FALSE
공산주의 초석 마련 도요타 이 쥬 덕분 대기업 들 정치 로비 하고 말안 들으면 정치 적 때려 죽이는 시대 덕분 그 많던 직장인 들 한순간 백 수 신 세로 전락 우 덜 식 경제 발전	FALSE
말 한마디 수십억 짜 리 맘대로 쓰는 재벌	FALSE
빚 뭔들 못 합니까	TRUE
고인 명복 빕니다	TRUE
우즈벡 서 정말 깜놀 했음 대우 ㅇㅇ	TRUE
북한 핵 개발 하 모든 책임진다던 구라쟁이 오늘 따라 유난히 도 생각난다	FALSE
고인 보내는건 종교 관련 없다 사람 일이	TRUE
영도 사람 들 쪽 팔란다 저런 인간 공 천주 살기 위해 라면 무슨 짖이라도 다 할 사람 대 낙선 자 위 이언주 공 감안 하십니까	FALSE
영 도살 수 십년 간 한국 당 표 구걸 만 우리 남 가했지만 분명 한남 넜 자칭 영도 출신 대통령 했지만 영도 눈 꽂만치 관심 없는 분 내년 총성 최소한 이런 정당 투표 않 한다 공천 받어면 당선 생각 하는 분 들 당신 들 과연 영도 눈꼽만치 관심 있는지 모르겠내 딴데가서 나온나 선거 때 시끄럽게 구 모습 꼴 보기 싫다 그리고 이언주 영도 이미지 좋다 투 펴 할지 않 할지 모르지만 한다면 이언주 한 표	FALSE
자유 한국 당 당적 변경 정답 빨리 가거라	TRUE
조선 호남 출신 뭐 그렇게 지역감정 부추겨야 하나	FALSE
무지개다리 건너야지	TRUE
생긴 걸 뭐라하긴 그렇지만	TRUE
대법원 판결 하는건 당연한거 아닌가	TRUE
대법 판결 난걸 이행 안 하는게 문제 아닌가 약자 는 재판 어려운데 대법 가서 이겨도 정부 나 몰라라 이러면 국가 시스템 믿을수가 있나	FALSE
대법 판결 직접 용했는데 정규직 시켜줘도 저 ㅈㄹ 떠네 ㅋㅋㅋㅋ 아니 아줌마 들 톨게이트 편하게 돈 받고싶으면 자회사 가라 쑈 하는거 토나온다 어휴	FALSE
대법 명 중 명 났음 그 명 이미 직고 용함 교육 억 발령 이미 다 났음 근데 문제 아무 것 안 연봉 계약서 조차 안 쓰고 떼 쓰고 있음	FALSE
계속 하이패스 바뀌는데 돈 받을 일이 어딨나 있는 사람 줄 다른 업무 넣어야 되는건 당연한건데 무조건 강 짜 부릴 일이 아니구만	FALSE
진짜 중소기업 일 할게 아니라 이렇게 공무원 되는게 좋을듯 ㅎㅎ 기계 대체 가능한 직종 그대 들 쓸 돈 다 내 중소기업 야근 하며 버 돈 중소기업 이직 해 같이 근로 환경 높이 자 지금 하이패스 일부 빼고 사람 수납 원 넣는 설계 하고 있음	FALSE
하이패스 전 국민 무상보 급 한다고 했나요 아니면 사람 필요하죠 톨게이트 관리 하이 페스 오류 사항 관리 수납 원 업무 그걸 꼼수 써서 자회사 보내려고 드는거고 대법원 그 짓 하지 말 판결 했는데 누가 강 짜놓고 있나요	FALSE
대법원 그 짓 하지말라고 판결 한적 없는데 직접 고용 후 보직 회사 권한 했는데 할줄아는게 날조 떼 쓰기 없는 아줌마 들 ㅋㅋㅋ 그만 좀 징징대라 으 휴 역겹다	FALSE
그리고 아 줌 마을 직고 해서 돈 낭비하는거보다 전 국민 하이패스 무상 급하는게 국가 적 이천만배 이득 ㅋㅋㅋㅋㅋ 쓰 잘데기 도 없는 인력 직고 해서 세금 낭비 될거 생각 하면 울화통 치밀어 오른다	FALSE
어지간히 해	FALSE
계약 직알 취업 했잖아요 정직 원하고싶으면 정식 시험 면접 보세요 무조건 아닙니다 어이 없네	FALSE
더러운 입 닫아라	FALSE
참 나쁜 사람	FALSE
근데 이 초등학교 선생님 들 아이 들 인원 수 줄어도 자기 들 자리는 무조건 만들어 달라 것 무엇 다른 하이패스 나날이 늘어가고 사람 들 필요 없는데 이렇게 무조건 정규직 시켜 달라 하 어떻게 하란 말 어느 직업 필요 없을 때 있다	FALSE
대통령 정규직 되라 뿅 하면 바로 정규직 됨 ㅋㅋ 그렇게 될 수 있었으면 진작 모든 대통령 들 공 약 이행 했지 판결 나도 결국 고용주 따라서 달린거고 더 많은 절차 있는 건데 뭐 만하 대통령 탓 그렇게 대통령 탓 싶으면 공산주의 외치	FALSE
이러면 누가 힘들게 공부 해서 대기업 공기업 갑 그냥 계약 직 갔다가 시위 해서 정규직 하지 그냥 우리나라 회사 들 다 국가 관리 해서 준 공영 노동자 들 공무원 전환 하지	FALSE
진짜 중소기업 일 할게 아니라 이렇게 공무원 되는게 좋을듯 ㅎㅎ 기계 대체 가능한 직종 그대 들 쓸 돈 다 내 중소기업 야근 하며 버 돈 중소기업 이직 해 같이 근로 환경 높이 자	FALSE
자 한당 지지율 나 됨 그거 되는게 신기하네 ㅋㅋㅋㅋㅋㅋ	FALSE
앞 안에 없어질 직업 종 정규직 해주 하면 그 후 그 이력 들 어디 써야하나요 도로 보수 공사 써야하나요 이건 들어줄수 없는 것 같아요	FALSE
이제 없어도 되는 직종 그대 들 먹여 살리고 정시 퇴근 시키기 위해 밤낮 야근 살 싶지 않다 딴 직장 구 하길 하이패스 기계 대체 가능한데 일부 톨게이트 설계 수납 원 있는것으로 바꾸고 있다는것을 국민 들 알아야 함 그리고 중소기업 같이 근무 환경 높이 자	FALSE
하청 업체 입사 해서 공기업 정규직 되고 공기업 직원 들 하는 순환 근무 거부 하는게 옳은 일인	TRUE
직업 체계 아수라 장 만들어 놨 어 정규 직원 들 일 할 맛 나겠습니까 이따위 선심 성 공약 가지 나라 운영 하니 노조 눈치 볼수밖에 없지 요새 머리띠 두르고 소리 큰 사람 들 대우받는 세상 아닙니까	FALSE
왠 대통령 법원 판결 기다리는 중 아닌가 첫 번째 대법원 판결 도로공사 직고 하겠다고 했고 두번째 판결 기다리는 중 아녀 거기 거 대통령 왜 나와	FALSE
대통령 약속 지키고 싶어도 이건 대통령 권한 밖 일임 대통령 혹시 도로공사 직접 연락 해서 사 장보고 고용 해라 하면 또 난리 날껄 직권남용 어쩌 하면서 자 한당 놈 들 들고 일어날께 뻔함	FALSE
한미 연합 훈련 비용 때문 중단 했는데 비용 때문 요금 징수 원 없 에구 카드 하이패스 로이 용하면 고속도로 비 팍 팍 내릴수있는것 아닌가	FALSE
근데 도로공사 자회사 정직 원 고용 다 고하 자기 들 걷어찬거아니야 자진 퇴사 한 것 들 왜 받아줘야되	FALSE
회사 방침 자회사 통한 톨게이트 운영 하겠다고 했으면 자회사 소속 일 해야 한다	TRUE
지랄 한다	FALSE
떼 악질 제발 그만하시오 억지 좀 ㅡ 그만 해	FALSE
촬영 때 포즈 잡느라 고생 많네 기차 놀이 하나 지금 날씨 딱좋치 여름 좀 하지 땅볕밑	TRUE
정규직 시험 정규직 된 겁니다 대기업 들 정규직 석 달 한번 씩 시험 보는는거 아시나요 비정규직 분들 정규직 되고 싶으면 시험 쳐서 정규직 한 면 됩니다 고등학교 졸업 하여 삼성 같은 대기업 절대 못 들어 갑니다 대학 졸업장 들고 들어가도 대기업 출제 하는 시험 통과 해야 입사 되는 겁니다	FALSE
공채 지원 하 되 가산 점 채용 시 호 봉인 정정 해주는것이 공정하다고 봅니다 저 분들 그냥 공기업 정직 원 들어주는것이 과연 공정한 사회 입	TRUE
대통령 절대 적 할 수 있다면 박근혜 나 이전 박정희 무죄 겠지요 공정하게 재판 받을수 있게 해달라 는게 대통령 권한 지법 과 절차 무시 다 면 그건 우리 원한 대통령 아니지요	FALSE
오 체 투지 내 살아오면서 다 소 호 불 미 추 따위 분별 심 지은 수많은 죄업 참 희하는 종교 의례 하는 꼴 보니 죄 덕지덕지 더 싿는것 같다	FALSE
얼마 받고 싶은거요 그래서 톨 비는 얼마나 올려야 하는거요	FALSE
죄송한데 앞 없어질 직업 중 하나 ㅠㅠ 편의점 무인 바뀌어가는데 앞 점점 일자리 기계 할 걸 프리 패스 늘어나듯이	FALSE
토나와 왜 들 저러는거야 도대체 깡패 따로 없네	FALSE
도데 체 하이패스 왜 안하는거냐 그거 진짜 똥 고집	FALSE
떼쓴다고 될 일 아님 촛불 아무 상관없음 생각 들 해보시오	FALSE
솔직히 좀 그래	FALSE
이강래 모가지 자른답니다 기대 하세요	FALSE
이런건 좀 아니지 않나요	FALSE
이 정부 상대로 시위 해서 정규직 못 따내면 바보 너 도나	FALSE
판결 못 하도록 대법 압력 이명 박근혜 정권 잊었냐	FALSE
약속 지키기 위 한 것	TRUE
나 같으면 저 지랄 떨 기력 시간 있으면 다른 일자리 구 하겠네	FALSE
전혀 공감 안된다	FALSE
국회의원 들 뭐 하시죠	FALSE
차가운 바닥 주무시면 입 돌아가요	FALSE
예수 부처 알라 탄원서 제출 한다해 친형 정신과 전문의 대면 진단 없이 정신병원 입원 시키려 했던 천 인공 노 할 죄 사라질수 없기에 찢지 사가 머물 곳 깜빵뿐	FALSE
종교인 노동조합 시도 위원 세계 각지 고려인 및 교민 들 철거 당 상 예 들 기도 힘든 이 모든 이 좌빨 누가 말 좀 해주오	FALSE
이재명 답 친형 정신병원 넣을 정도 넣을만 했으니 했겠지 이 그 들아 이재명 살려 두라 이재명 민주당 구원 할것이다	TRUE
세금 니 들 돈 그만 뜯어 먹어라 니 자식 들 힘들어 진다	FALSE
들어갈 때 알 들어갔잖아요 그 곳도 연줄 돈줄 돼야 들어갈수있 는걸 알고있는데 공기업 비정규직 들 입사 비리 전수 조사 해야 된다고 생각 합니다 비정규직 정규직 누구 부당함에 대해 말 할수있다면 불공정 공기업 지방 공무원 입사 부정 과정 부당한 결과 맞이 응시 자 들이 우선 되어야 합니다 아는 사람 다 알 않습니까 다 그런건 아니겠지만 어떤 사람 들 어떻게 들어가고 어떻게 일 있는지 아마 자신 들 더 잘아실 겁니다	FALSE
공정하게 시험 쳐서 입사 하세요	TRUE
하 신부 님 정치 판 끼어 드려거든 사제직 내려놓으세요 저런 사제 들 꼭 신성한 미사 시간 정치 얘기 함 분심 들	FALSE
오후 막히는 시간 종로 가 메인 로드 횡단보도 드러누워 교통 방해 하는데 경찰 멀둥멀둥 쳐다보고만 있고 너무 짜증 났음 자기 주장 남 피 해주면서 하는 이유 무엇 일까 대한민국 경찰 이제 이익단체 눈치 보는 곳 전락 함	FALSE
이익단체 눈치 보는 거 하루 이틀 일이 었나 도로공사 김천 본사 가시 많이 계셔요	FALSE
그러면 노동자 하지 사무직 하지 공부 하기 싫어서 들어간 회사 징징 거리	FALSE
정당하게 시험 쳐서 들어가세요 어렵게 공부 해서 시험 합격 해 들어간 사람 들 뭐 됩니까 때 쓰니깐 다해 주는 지금 정부 나중 정권 바뀌면 또 구조조정 쯧쯧 때 쓰면 다해 주니 이 사단 나 겁니다 도로공사 톨게이트 요금 받는 부서 자체 없다고 들었는데 정직 원 되면 고속도로 가서 위험한 일 할 수 있겠어요	FALSE
노동시장 비정규직 필요하시구나 니 자식새끼 비 정규직 하면 되겠네	FALSE
그냥 다 없애 버립시다 지금 하이패스 장착 기본 딜려 나오는데 꼭 톨게이트 수납 노동자 저렇게 많이 필요할까 요 문죄인 정신차려라	FALSE
어차피 하이패스 없어질 직 군	FALSE
싸 악 짤 라라	FALSE
불법 파견 해고 말 되는거냐 법도 인정 했는데 아니라고 판결 받고 오라 건 떼쓰는거 아니냐 법위 있는 이강래 배임 조사 해	FALSE
아 관심 없다 나도 정직 원 될려고 잘 보일려고 힘들게 일 있지만 너무한거 같네	FALSE
노령 연금 지하철 노인 무료 없애는 우파 무조건 표 줍니다	TRUE
한국 도로공사 이강래 구속 수사 임 직원 도피 부정 관련 자 들 수사 해라 그럼 청년 구직 자 들 일자리 늘어난다	FALSE
무슨 피해 도공 정규직 자리 달라 것 아니고 수납 근무 시키면 될 걸 직접 용해서 중간 착취 그만하라는 건데 그 것 무서워서 집단 해고 시키고 기간 제 써서 이 난리 만드 도공 정규직 욕심 문제 수납 근무 직접 고용 시켜줄 마음 없는게 문제	FALSE
댁 걱정 이나 하 슈 알지도 못 하면서 주절거리지말고	FALSE
이런 걸 보고 버릇 더럽게 들였다고 하는거 안되는거 전부 저런 식 해서 되니까 다 들 저러네 안 하는 사람 들 바보 되는거 대출 만해 그렇다 성실히 돈 갚는 사람 바보 만들고	FALSE
대법 판결 수납 원 손 들어줬는데 안되는거라는 말 조금 어긋나는거 같네요	FALSE
원래 정규직 였다 간 개 부터 먹고 최저임금 복지 사각 잦은 해고 그만해야 된다	FALSE
취준생 기회 뺏지마라 정규직 장난 젊은세 대의 길 열어주어야지 자기 밥그릇 자기 생존 주장 하려면 시험 봐서 정정당당하게 정규직 해라	TRUE
욕심 좀 그만 부려라 ㅗ	FALSE
욕심 이강래 그러게 자회사 꼼수 뭔가	FALSE
지 랄 풍년 욕심 느그 들 잘혀 니 혀 바닥 뱀 새 끼 처럼 놀리지말고	FALSE
공부 할 생각 안 무작정 떼쓰며 들어가려는 개돼지 들 ㅋㅋ 너 같은것 들은 그래서 안되 ㅉㅉ	FALSE
니 세금 강 가 먹고 있는거야 세상 돌아가는것 좀 알 떠들어라 글 니 자식 비정규직 되길	FALSE
야 너 세상 불만 있지 강 만 세금 쳐 먹냐 대통령 세금 처 먹는다 그리고 때스지마 비정규직 들어왔잖아 지금 세수 줄돈 없으니까 그만 징징 대	FALSE
어차피 점차 적 불필요한 인력 될 것 정규직 아니고 계약 직 뽑는 건데 역 미래 위태 로우 정식 직원 바꿔 달라 떼 쓰네요 그냥 다른 자리 알 보세요	FALSE
개월집 나와서 저러는게 욕심 씨부리는 당신 머리 도대체 뭐 들 엇 나싶소 개 못 인간 입 묻고 싶은데요 뉴스 안 봅니까 이강래 지금 어떻 게 사는지 더러워서 얘기 하기 싫다만 당 신 인생 똑바로 사 쇼 무뇌아 아닌 이상 어찌 입 담지못 할말을 담고 사는지 쯧쯧	FALSE
이강래 더러우면 톨게이트 수납 원 공기업 직고 용되 야하나요 솔직히 사장 이월 급 주는것도 아니고 일부 세금 아닌가요 사장 사장 대 톨게이트 수납 원 없어지는 직업 맞는거지	FALSE
불공정 해보인다고 투쟁 어떻게 어떻게 넘어간다고 칩시다 본인 들 불공정 하다고 외치 왜 다른 불공정 만드십니까 그리고 종교 종교 답 정치 참여 안 했으면 합니다 그게 기독교 불교 천주교 어떤 상황 일지 정치 적 수단 종교 는걸 이용 하지 맙시	FALSE
이 보시 억울하오 정규직 다 같은 조건 입사 월급 하는 일도 같아야 되는데 그건 어찌 생각 하시오 이 들 없으면 느그 들 할거니 니 밥그릇 뺏는거 아니 신경 끄고 공부 열심히 해 진급 해야지	FALSE
님같음 서비스 직 저 월급 받고 저런 면접 볼건 가요 답답하다	FALSE
하이패스 다 갑시다 IoT cloud 세상 뭔 요금 수납 입 하이패스 필요없이 번호판 인식 후 연결 계좌 그냥 빠지게 하면 됩니다 바닥 엎드려서 세기 수납 사세요	FALSE
다 하이패스 바뀌는데 징수 원 자리 없어지면 도로공사 뭐 하게 그때 출퇴근 도장 찍으면서 정년 기다리게	FALSE
으이구 당신 자식 들 앞길 좀 막지 마세요 부끄럽지도 않으십니까 그렇게 정규직 좋으면 공부 해서 시험 쳐서 들어가세요 그 사람 들 바보 입 어린 애 들 떼쓰면 다 들어주는 그런 법 있는 건지 무조건 어거지 지겹다 지겨워	FALSE
으이구 이글 쓰시 붓 아주 마니 부끄럽네요 당 신부 모이거나 당신 지인 입니다 공부 해서 시험 쳐서 들어가 저 월급 받을 겁 당신 나도 지겹다 생각 없이 댓글다는 사람 들	FALSE
저 거 위법 아니냐 차도 지랄 인도 나 두고 다잡아 처 넣어라	FALSE
정규직 하고 싶으면 너희 들 당당히 시험 보고 들어가 그럼 아무 뭐라 안해	FALSE
채용 공고 뜨면 공평하게 서류 합격 인적 성 ncs 차 면접 차 면접 최종 합격 이렇게 해야 정직 원 이러면 정규직 엄청난 경쟁률 뚫고 들어온 사람 뭐 되냐 ㅡㅡ	FALSE
저 일 저 월급 받고 당신 같음 해	FALSE
AI 시대 요금 수납 원 정규직 말 된다 생각 하는지 다른 직업 차라리 찾아 달라 고해 비 효율 적 해달라하니 안 들어주지 ㅉㅉ	FALSE
ㅎㅎㅎ 정규직 되려고 피땀 흘리는 사람과 그냥 되려는 사람 차이겠지 차량 통행 방해 얼마나 되었을까 그 차량 운전자 들 기름값 보상 해주고 길막해 이 띠부럴것들	FALSE
힘내세요 내년 볕 들 날 옵니다 조금 더 버티세요	TRUE
프랑스 비교 자료 떴더라 귀족 노조 잡아내니 지디 피 올라가고 고용 률 올라간거 우리나라 복지 과연 나쁜 건지 다시 생각 해봐 야한다	FALSE
평등한건 시험 입사 하는 겁니다	TRUE
여편네 들 집 구석 서 밥 해 니 들 땜 톨비 올라간다 잠 못자고 공부 하는 애 들 뭐 데니	FALSE
공부 하는 애 들 수납 원일 안 한다 언제 쯤 되면 알겠니	FALSE
이런건 좀 한정 곳 하면 안되나 허구 언 날 도로 통제 해서 일반인 피 해봄	FALSE
노력 해서 밥그릇 하나 겨우 겨우 마련 했더니 노력 안 사람 들 그 밥그릇 뺏어가면서 되려 나눠주질 않는다며 노력 사람 들 나쁜 사람 만들어 버립니다 비정규직 철폐 좋고 근무 환경 개선 좋습니다 근데 왜 꼭 직고 용이 어 하나요 자회사 싫다 무조건 공기업 직원 시켜 달라 여기저기 난리 입니다 지금 뭔가 주객 전도 된 느낌 이런 기세 라면 우리나라 노력 해서 뭔가 이뤄 낼 사람 없어요	FALSE
어차피 차차 사라질 일자리 직접 고용 안 하는 겁니다 언젠가 정리 해야 할 인력 우리나라 직접 고용 하면 정규직 기본 적 정년 책임져야 하고 정리 하려면 큰 비용 드니까 요 사실 상 미래 산업 변화 대비 해서 박근혜 총대 메고 쉬운 해고 도입 하려고 하다가 노동자 들 조직 적 반격 탄핵 당했죠 나도 노동자 이 시 대 흐름 역행 하긴 해 OECD 기준 한국 노동 경 직성 높다고 평가 했죠	FALSE
도로공사 톨게이트 수납 일자리 공고 내고 정식 시험 치게 정직 뽑아라 시험 쳐서 ㅜ 당당히 정직 될 길 열어 주세요	TRUE
하이패스 활성화 되는데 수납 원 왜 필요해 정규직 시켜서 어디 써 먹나	FALSE
시험 쳐서 들어가야지요 밤낮 코피 터지게 공부 하는 취업 준비 생 생각 해보세요	FALSE
허참 정의 사회 고사하고 개 나소 세월 타령 한 몫 챙길 생각 뿐 문제 사회	FALSE
그럴 시간 도서관 공부 해	FALSE
댓글알바 들 여기는 이미 판결 나왔다도 공 알바 어쩐지	FALSE
별 짓 다 하네 머 투쟁 하면 다 되는구나 진짜 욕 나온다	FALSE
너 나잘해 OOO	FALSE
나도 너 욕 나온다	FALSE
초 중 고 학생 들 학교 청소 시키지 마라 공부 하러 간거지 청소 하러 간거 아니다	FALSE
무 양심 인간 들 하는 짓 전교조 똑같네	FALSE
네 얼씨구	TRUE
시험 제일 공정합니다	TRUE
나 공무원 하고싶다 나 같은 생각 있는 사람 들 모아서 투쟁 하면 공무원 시켜주냐	FALSE
상 시 지속 적 용역 개 근무 하면 된다	FALSE
시험 바서 들어가라	FALSE
길거리 쓰레기 많아지네	FALSE
기생충 들 사회 아무런 도움 안되면서 밥 축 내는 놈 들 이 노력 장사 해도 성공하겠다	FALSE
한심한지고	FALSE
문재인 정권 비정규직 더 많이 양산 시킨다 공약 지킨거 머 있냐 민주당 사람 들	FALSE
오 체고 지랄 일하기 싫으면 그만둬라 요금 수납 전 자동 해서다 계약 해지 해	FALSE
산개 후 낮은 포복 작 전 지점 신속히 이동해	FALSE
법정스님 한마디 무소유 욕심 끝 없네	TRUE
법치 사회 국가 대한민국 대법 판결 승소 수납 원 들 직접 용이 정답 법 왜 있는 겁 왜 저 들 해고 요금 수납 원 들이 저 힘 고행 했을까요 뭘 잘못 해서겠습니까 바램 가정 일터 돌아가게 해달라는 바램 그것 그리 큰 새때 버릇 없는 행동 말입 아래 댓글 다 신분 들 당신 들 ㅇ 분명 도로공사 구 사대 또는 돈 몆푼 영혼 ㅇ 팔고 있는 댓글 알바 부대 들 아무리 자본 힘 이라지만 정부 댓글알바 그런 막말 하는거아니라 사 뢰 됩니다	FALSE
개 소나 투쟁 띠 두르고 집회 하네 수납 원 개뿔 만화책 방이 없어진것처럼 하이패스 끝내고 딴 일 잡 자	FALSE
국민 일자리 만들어 주는 것 나라 할 일이 기계 설치 하면 대기업 유착 정치인 살아남는다 너 사 측 댓글 알바 비 받냐 아님 도공 정규직	FALSE
문재인 버릇 잘 못 들였어 이러다 진짜 공산당 되겠어 다 똑같이 대우받는	FALSE
비정규직 없애라	TRUE
제 공항 추진 되어야 합니다 꼭	TRUE
왜 주장 만 뒷받침 하는 근거 없으면안되 자	FALSE
몰라 진짜	FALSE
종북 좌빨 넘 들은 졸라 새만금 되고 제주도 안됨 그 돈 졸라 이용 율 제로 공항 하나 더 만들어 줘 야함	FALSE
땅 투기 하셨어요	FALSE
반대 하는 이유 딱 나왔네 개발이익 다른 이 들 가져 간다 친절히 기사 써주셨는데 자기 들 혜택 없을거 같으니 반대 다 고하 환경 핑계 대지 솔직해지자 돈좀 더 달라 그럼 최소한 동정 하지 자신 들 이익 환경 붙이 말라 언제 부터 환경 생각 살았는가 그저 돈더 받고싶어서 환경 핑계 대는게 보이는구만 자기 이익 없다고 무조건 적 반대 설득 력 있는 이유 말 해라 그냥 수용 하는것도 아니고 보상 해주는데	FALSE
월 모든 개발 산업 환경 론 자 지역 주민 반대 하는 사람 있고 다만 지역 주민 과반 찬성 하면 해야 조	TRUE
반대파 들 할 일 없으니 때 쓰고 난리 구나 할 일 없으면 그냥 자라 제주도 숙원 사업 전세계 잘살아지면서 여행객 들 급증 하면서 항공기 증설 신 공항 건설 등 하고 있다 제주 돈 빚 전국 가장 많은 사람 들 다돈버는건 여행 업 배불러서 노 종교 단체 세금 받아 쓰는 환경 단체 들 참 무대 포 무식하 넘 들 지 구 밖 보내야 한다 제주 의 역적 들	FALSE
공론 회 거쳐 마지막 단계 상황 일부 반 대자 들 있다고 해서 공사 무산 한다는 게 말 되는 소리 입	FALSE
왜 이호 유원지 통과 시킨 겁 왜 도의 회 공항 반대 이호 유원지 통과 시킨 거 구 이호 유원지 대기업 배 불리는 전형 적 사업 임 불구 한 데 말 이오 제주 공항 적게는 대한민국 사람 들 넓게는 전세계 사람 들 안전하고 편안한 여행 할 수 있는 좋은 시설 임 불구 어찌 이 거 반대 하고 있는 것 김태석 박 원철 물읍시다 솔까말 제주 동쪽 발전 되면 자기 지역구 어려워질까봐 그러는 거임 이런 이 기적 사람 들 그러니 민주당 욕먹는 거	FALSE
제주도 우리나라 아닌가 ㅡ 관광객 조율 한다는 게 말 되나 ㅡ 공항 신설 꼭 필요합니다	FALSE
언제 도민 숙원 뮈 하더니 이 젠 환경 타령 ㅡ 자 그럼 제 주 공항 폐쇄 하자	FALSE
공항 짓기로 결정 했으면 보상 잘 해주고 빨리 시작 합시다 모든 문제 돈 환경 평가 타당성조사 반대 하는 사람 들 논리 무한 만들 수 있습니다 보상 부족하니 반대 하는거지요 공항 발표 되고 땅값 올랐는데 보상 받은 금액 한 평생 살아온 동네 땅 살 수 없어서 반대 하는거지 다른 이유 있겠습니까 지금 성산 주민 들 공항 들어와서 땅값 오르고 개발 되는데 반대 하는 사람 들 누가 있겠습니까 단 같은 동네 사람 들 보상 받은 돈 같은 동네 들어오지 못 하니 미안해서 찬성 한다고 대놓고 말 안 하는거지 공항 들어오는데 누가 싫어하겠습니까	TRUE
제 공항 필요하니깐 만드는 겁니다 저번 주 토요일 서울 사는 지인 아버님 위중해서 제주 가야 하는데 비행기표 없어서 공항 다섯 시간 대기 했고 결국 임종 못 보셨습니다 당신 들 제 주 도민 고충 아십니까 횐 경 보호 할 거 아파트 살지말고 차도 타지 자연 숲속 들어가서 사세요 제 주 도민 고충 모르면서 이런 반 댕 산하는 이런 기사 매우 기분 나쁩니다	FALSE
예전 제주도 아니예요 차도 너무 막히고 건물 많아지고 오염 심해지고 관광지 아니라 도시 되가는 느낌 입니다 제주도 도시 만들려고 공항 건설 하는 겁 도시 바다 건너면 많아요 비슷 비슷한 그런 도시 만들려고 그 돈 퍼 쓸꺼냐 고요 눈물 나네요	FALSE
야 멍청한 제주 도민 외 대모 시 위자 들 경부 고속도로 건설 할 때 너희 잘난 대중 이영 삼이 모두 반대 했었다 그런데 지금 경부 고속도로 쓸모 없는 도로 왜 힌치 앞 못 보는거냐 성격 지랄	FALSE
신부 님 들 왜 그러셔요 왜 이런 일 끼어듭 ㅡㅡ	FALSE
추진 되어야 한다 그 래야 제주도 환경 파괴 되서 바가지 없어지지	TRUE
제 공항 신설 된다고 제주 자연 파괴 그야말로 억지	FALSE
남잘 되는거는 배 아프고 그러니 떼쓰고 콩 고물 좀 받아 보자 이 것 뿐 신 공항 입지 선정 선정 지금 시간 한참 지났다 이제 서 이 짓거리 하는게 뭐 겠냐 ㅋㅋ	FALSE
곧 발표 나겠군요 저리 소수 설치는 걸 보니 ᆢ	FALSE
제 공항 추진 해 주세요 지금 공항 넘 불편합니다	FALSE
관광객 위해 개발 우선	TRUE
당신 들 끼리 별도 살아요 중앙정부 지원 받지말고 각자 도생 하자	TRUE
일단 멈추고 천천히 가는 것 맞다	TRUE
제주 해군기지 몇몇 종북 사들이 어리석은 국민 들 꼬드겨 수천억 의 국고 낭비하게 하였고 국가 발전 가로막 사건 이었다 똑같은 인간 들 또 똑같이 제주 발전 방해 나섰다 이 들 국가 모든 발전 건설 장소 어김없이 나타나 국가 혼란 부추긴다 이를 막 방법 국민 들 이 들 싸늘하게 반 대 의사 분명히 하여 대한민국 더 이상 발 붙이 못 하도록 해야하는 것	FALSE
그럼 바다 위 지읍시다	TRUE
도민 숙원 현실 도민 반대 바라는데로 하지 마	FALSE
오라 관광 단지 는 합시다 그 주변 땅 좀 있어서 ㅋㅋㅋ 신 공항 반대 합니다 그 쪽 주변 땅 없거든요 결사 반대	FALSE
평화 섬 제주 미군 핵 전투기 기지 건설 반대	FALSE
떼법 쓰는것 들 평생 저러고 살라	FALSE
저 정신 력 다른 걸 하지	FALSE
우리나라 노동자 대신 하여 톨게이트 수납 원 응원 합니다 청와대 일 좀 바르게 해 주시 전 수석 작자 자 한당 같은 막말 하던데 그 정신 다음 정권 희박합니다 내년 총선 자 한당 ㅆㄹㄱ 통 쳐 넣고 다음 민주당 차례 될 수도 있습니다 바른 정신 바른 정치 좀 하세요 청와대 알았어요	TRUE
한국 도로공사 공기업 대통령 지정 도로공사 사장 두 군데 다 노동자 길거리 내몬 공범 들 명 해고 것 모자라 대법 톨게이트 요금 수납 원 업무 불법 파견 이므로 직접 용하는것이 맞다라고 했는데 두 곳 다 모로 쇠 이 진정 어느 나라 대한민국 법치국가 맞긴 한 건가 벌써 개월 째 이 리 들 방치 해도 되는거냐 고요 이 것 대통령 님 노동 존중 받는 사회 비정규직 제로 화하겠다는 것 였나요 비정규직 제로 화 맞긴 하네요 비정규직 노동자 들 다 잘라내면 제로 되겠군요 그것 대통령 님 꼼수 였나요	FALSE
톨게이트 노동자 힘내라	TRUE
대법 판결 무시 하는 도로공사 공공기관 청와대 국토부 공범	FALSE
응원 합니다 처음 같이 이제 항상 영원히 그러고 사시길	TRUE
이단 교회 목사 이름 사탄 앞잡이 된 목사 언행 정상 일 수가 없지요 교회 신학 대학 사회주의 공산주의 종북세력 침투 하였음 이 개탄 스럽습니다	FALSE
난 이재명 조아	TRUE
경제 박사 천재 이재명 차기 대통령 님 힘내세요 건강하세요 응원 합니다 ♡♡	TRUE
이재명 경 기 도지사 님 응원 합니다	TRUE
여자 프로파일러 미인계 썼 단말 여자 우습게 아 네	FALSE
나쁜 놈 들 생각 하면 사형 집행 했으면 좋겠다가도 차 사건 억울한 범인 몰려 간 옥살이 윤모씨 생각 하면 그 사람 억울한 사람 생기 어쩌나 싶 기도	FALSE
앞 문제 조두순 법 국민보호 안 해주니 방법 내내 조두순 현재 사진 내보내서 모든 국민 머리 각인 시키는 방법 뿐 그러면 지가 자살 하겠지 아닌가 자살 기대하면 안될 라나 암튼 참 어려운 놈 안산 주민 들 참어쩌	FALSE
그래서 나도 성악설 맞다고 본다 인간 변하지 않더라 그래서 관리 나라 해줘야 하는거고 한국 재판 반드시 없애야하는게 반 성 문 참작 피해자 선처 요구 이건 반드시 없애고 재판 해야 한다	FALSE
누명 쓰고 억울하게 감옥살이 윤씨 보면 사형제 폐지 아닌 것 같고 ㅡㅡㅡㅡ 휴	FALSE
조두순 국민 들 십 시 일반 돈 모아서 당시 검사 판사 살던 동네 집 구해 살 해주자 누가 나서 주 기만 하 금전 적 기부 할 의향 있다	TRUE
프로파일 리도 극 한 직업 듯	FALSE
교정본부 직원 들 뇌물 받고 들여 준 것 아니냐 소지품 검사 하고 있었을텐데 몰랐다는 것 말 되나 책임 져라	FALSE
사형 실시 반대 하는 여성가족부 인권위 뭐 느끼는 거 없냐 그리고 뭐 이상한 걸 잡히면 전자발찌 공개 고지 감시 이딴 거 하면서 고통 주려는 사이코패스 하는 짓 다르지 잔인하기는 똑같다 김영삼 정븨 사형 실시 하 미국 국민 다 총기 자유 국가 부수 적 그런 법 해야되 겠지만 한국 사형 실시 해법	FALSE
범죄자 업그레이드 후 출시 밥 빌어 처 먹고 사는 대한민국 사법부	FALSE
흉악 범 사형제 부활 더 많은 생명 구한 다 사법부 살인자 자비 베푸는것은 멀쩡한 사람 들 사라 질것이다	FALSE
그렇지 교도소 여자 볼 수 조차 없으니 여자 그리웠겠지 여자 만날 수 있다는 기쁨 공 소 시효 끝났음에도 면담 했겠지 수 사관 쪽 그걸 눈치 채고 이쁜 여자 수 사관 위주 투입 했을 거고 화장 이쁘게 해서 보내서 이춘 재의 적극 적 태도 유도 했을 거	FALSE
이춘 재 정말 화성 살인 사건 범인 일까 나 왜 자꾸 의심 가지 dna 가 일치 하면 무조건 범인 결국 모든 살인 사건 dna 만 일치 하면 무조건 범인 것	FALSE
의심 병적 ㅋㅋㅋㅋ	FALSE
자백 했 자 돌빡	FALSE
인권 할 때 인 사람인 짐승 인권 단어 맞지 않다	FALSE
이춘 재는 자지 불알 잘라 야한다	FALSE
사고 예상 되는 상황 손 놓고 있으면 정부 책임져야 한다 책임 떠 넘기기 좋아하는 정부 또 누구 탓 할지 모르겠지만	FALSE
우리나라 유명 연쇄살인범 어느 누구 하나 사형 집행 안 되었지 자살 정남규 빼고 명 죽인 사형수 집행 됐는데 연쇄살인범 연 속 출현 이후 협집행 정지 되어 있어서	FALSE
왜 사람 들 조두순 두려워하는가 조두순 이 사람 들 두려워 해서 교도소 못 나온다 해야 순리 아닌가 두려움 가진자는 평화 소유 할수 없다	FALSE
이수정 범죄심리학 교수 한참 멀었네 여자 좋아하다가 아니라 자신 잘 못 된 성 다스릴줄 몰라서 해야지 니 무슨 교수 ㅗ	FALSE
인권 취약 했다 과거 이야기 로만 돌 리기 너무도 피해 컸다 사죄 할 것 사죄 앞 이런 일 들 없으면 좋겠습니다	FALSE
법안 올 렿 는데 자 한 당 새끼 들 아 놔	FALSE
이춘 재도 재 조사 삶은소 대가리 조사 좀 해	FALSE
사형 폐지 반대	FALSE
이수정 님 그나마 명쾌하고 피해자 편애 말 해주는 분 없는듯 응원 합니다	TRUE
흉악 범 사형제 폐지 자체 적용 하지말아야 되지 않을까	FALSE
진범 밝혀졌으니 피해자 민사소송 할 수 없냐 이춘 재네 집 보상 나와서 부자 됐다면서 피해자 지금 손 배소 해야하는거 아니냐	FALSE
우리나라 프로파일러 들 특징 범인 잡기전에는 특정 못 하더니 잡고나면 엄청 분석 해 댄다 국 개 의원 된 모씨 최강 마치 시험 칠 땐 빵점 맞아놓고 채점 나 아 맞다 이러는거 같음	FALSE
이춘 재 주변 사람 들 이춘 재 착한 사람 알았듯이 누가 싸이코 예상 할수 없다 저 교수 싸이코 일 수도 있다 저런 사건 파면 대리 만족하고 있을지도 모른다 원래 저런건 보통사람 할수있는 직업 아니다	FALSE
단체 장 맡는건 우리나라 정치 싶다는 거지	TRUE
국선변호인 선임 하느니 혼자 변론 하는게 훨씬 유리할거다 대다수 국선변호인 나 변론 시간 변론 기회 오히려 없애는 사람	FALSE
사형 집행 해야 한다 욕정 덩어리 언제 떠질지 모른다 씨 말 려	FALSE
근데 왜 이 새 기 기사 고 유정 지겨워 빠진 기사 톱임 고마 좀 즙 짜고 이 새 기 기사 좀 올려 봐 봐 경찰 비리 수 사랑 여 년 간 미제 사건 이었 떤게 풀렸는데 시 벌 고 유정 발언 기사 없노 좀	FALSE
누명 쓰고 망가진 인생 된 윤씨 억울함은 누가 책임지나	FALSE
개풀 뜯어 먹는 소리 하네 물어봤냐 저 페미 아줌마 뭔 데 자꾸 나오냐 죄다 답정 너드	FALSE
어디가 될지는 모르겠지만 그 동네 사람 들 어떻게 살겠나	FALSE
프로파일러 실력 단지 여자라서 자백 했다로 후려치는 겁	FALSE
이진구 논설 위원 프로필 사진 좀 바꿔야	FALSE
윤씨 단 번 변호사 면담 적 없었다고 밝혔다	FALSE
조두순 악마 나온다니 넘 끔찍하다 대 곧 죽 영감 들 마을 지적장애 소녀 성폭행 뉴스 종종 나던데	FALSE
여자 들 없는 곳 살 착하게 지낸다 가설 이군	FALSE
수 사망 좁혀오자 유시민 유럽 도망 가던데 진짜 역겨운 놈	FALSE
차 사건 누명 쓴 분 꼭 무죄 선고 받고 민사 경찰 걸어요 똥줄좀 타라	FALSE
종교 가장 정치단체 들 본색 드러내는구만 ㅎㅎㅎ	FALSE
그럼 대한민국 법 존재 할 필요 없지요 이 거 진짜 이나라 왜 이 꼴 됐지요 법원 판결 기다리는게 정상 무슨 헌재 무죄 신청 하질안하나 참 개판	FALSE
법대 하는거야 OOO 아	FALSE
경 기 조폭 협의 회 탄원서 안내	FALSE
판사 들 초딩 봐도 웃 판결 집어 쳐라 또 애민 행정 이재명 이렇게 민심 얻었다 경기도 뿐 아니라 전국 긱계 각층	FALSE
탄원서 쓴 사람 들 존경 한다 이재명 도지사 정치인 중 제일 나은거 다 들 알잖아 완전 응원 다	TRUE
진정한 믿음 가진 분 들 이재명 같은 진정한 일꾼 눈 보이지 그 들 사명 응 다해 하는 순간 임 아는거죠 감사합니다	TRUE
적폐 판사 한넘의쉥키 나라 어지럽히다 임 상기 단두대 올려라 니 깨끗한지 이재명 깨끗한지 국민 들 판단 하자	TRUE
조 둥이 다물라	FALSE
니 조동아리 보터 물라 적폐 똥파리 알바 쉥키	FALSE
얼마나 억 지 판결 했으면 많은 사람 들 이렇게 지지 할까 요 모두 들 김 사합니다	TRUE
갓 재 명	TRUE
이재명 무죄 국민 들 보고 정진 하세요	TRUE
종교인 양심 쓴 탄원서 이 시대 정의 종교인 들 있다니 너무 감사하고 고마운 일이	TRUE
이재명 지사 무죄 입니다 모두 들 참여 하세요	TRUE
이재명 지사 죄 없다는건 세상 누구 다 알 종굥인들 나서주는거 보면 정치 재판 똑똑한 정치인 희생 된다는건 안타까워 서겠지 서민 위 행정 탁월한 이재명	TRUE
똥파리 들 종교 뿐 아니라 국내 해외 일반인 들 나서고있다 여태 정치인 위해 이렇게 사람 들 노력 하는거 봤냐 그만큼 이재명 옳다 방 구석 악플 알바 놈 들	TRUE
종교 세금 물리 이 단 종교 없에는 탄원서 네 자 쓰레기 집단	FALSE
종교인 종교 신경 쓰자	TRUE
누가 탄원 햇 는지 헐 종교 단체 저건 아니다	FALSE
죄 지 엇으 법데 이 젠 종교 썩 엇네	FALSE
종교인 빨갱이 안되는데 빨갱이 종교인 될 수 있다	FALSE
정신병원 활용 쌍욕 질 회피 질 협박 질 구라질 고 소질 없이 적폐 청산 공정 국가 이루기란 에베레스트 꼭대기 km 짜리 마천루 세우기 보다 훨씬 어렵다 ㅡ 곧 깜빵가 전과 범 될 찢 죄명 ㅡ	FALSE
저런 미친 단체 있었나 다 더불어당 패거리 들	FALSE
교황 전세계 모든 신부 목사 친필 탄원서 대법원 제출 한다해 친형 정신과 전문의 대면 진단 없이 정신병원 입원 시키려 했던 천 인공 노 할 죄 사라질수 없기에 찢지 사가 머물 곳 오직 깜 빵 뿐	FALSE
종교 믿으면 믿었지 이 무슨 해괘 짓거리 공정한 사법부 싸우자는 것 항소 이재명 권력 남용 적페 적용 해 징역 에 벌금형 선고 하 도덕성 윤리 상실한 이재명 영구 재 명 해야 한다 자 한당 뭣들 하는가 이재명 OUT	FALSE
공적자금 사용 처 찢 시장 질의 하다 직 간접 건의 고소 당하고 보호자 동의 없이 성남 경찰 의해 정신병원 감금 되어 아티반 할로페리돌 정상 투 여량 네 배 투여 받고 떡실신 되었다가 극적 구출 된 김사랑 씨 사건 뒷 배 그 악마 섹희 과연 누굴까 머슴 씨부리던 시장 주권 자 국민 정당한 질의 하는것이 고 소질 당할 일인 경찰 도대체 왜 통닭 먹어려 지인 만나러 가는 멀쩡한 김사랑 씨 보호자 동의 없이 정신병원 강제 입원 시켰을까 김사랑 씨 구출 되지 않았었다면 지금 살아나 있었을까	FALSE
법 위반 했으면 당연히 처벌 받아야지 종교인 들 무슨 권한 수법 관여 하는	FALSE
대표 성도 없고 그냥 그 쪽 사람 들 모임인듯 혹시 김일성 하나님 이 부처 하면서 종교 생활 하는건 아니지 그런데도 있다 더	FALSE
제주 공항 넘 정신 없다 사고 기전 빨리 추진 해라	FALSE
이번 제주도 뱅기 큰 사고 날뻔햇잔 그냥 편하게 공항 넓 직하게 이용 하자 진짜 도때기 시장 아니고 외국 보기 부끄럽다	FALSE
예 이 자석 마음 곱 써라	TRUE
시민단체 이 놈 들 반대 직업 도민 아니면서 도민 들 바램 짓 밟고 제 공항 끝나면 딴데가서 또 같은 짓거리 할 더런 놈 들	FALSE
빨리 좀 짓자 불편해서 못 다니겠다	FALSE
만약 공사 들어가서 자연 파괴 심각해 지면 그것 문 재앙 책임 되는 것 그런 줄 알어라 무조건 막아라 그게 문 재앙 민주당 주어진 사명 그거 못 막고 허가 해주면 내년 총선 민주당 완전 망하는 거야 제주 도민 들 는 자연 파괴 넘어서 자연 멸망 불러오는 공항 반대 압도 적 찬성 하는 것 들 온 평리 땅 어치 씩 사 놓은 새 기 들 뿐 투기 위해 제 주 도민 갑자기 된 일명 가짜 제주 도민 들이 찬성 거야	FALSE
안 되면 다음 대권 끝 줄 알아라	FALSE
너 차 타고 다니지 자연 파괴 하지말고 걸어 다녀	FALSE
부디 취소 하시여 제주도 지켜주십시요 ᆢ	TRUE
반대 하시는 분 들 자연 위해 반대 하는건 알겠는데 제주도 「 당신 들 껍 」	FALSE
친형 정신과 전문의 대면 진단 없이 정신병원 입원 시키려 했던 천하 둘 없을 패륜 정치인 전과 범 찢지 사를 위해 어찌 종교인 들 탄원서 제출 할수 있 단말 교황 전세계 모든 신부 부처 환생 해서 친필 탄원서 작성 해서 대법원 제출 한다해 찢지 사의 천 인공 노 할 죄 사라질수 없기에 찢지 사가 머물 곳 오직 깜빵뿐	FALSE
갓 재 명	TRUE
식당 들 편의점 고속도로 점점 무인 화 되어가는데 무턱 대고 다 정규직 전환 하 그 사회 적 비용 누가 감당 하나요 또 세금 퍼 주는건 가요	FALSE
진짜 그 정신 공부 해서 당당히 들어가라	TRUE
아스팔트 괙괙거리 정규직 할 수 있는거냐	FALSE
이 쓰레기 들 또 뭐 ㅋㅋㅋㅋㅋㅋ 재앙 이 때 쓰고 적당히 민주당 인척 하면 뭐라고 주 그러는거냐 나라 꼬 보소 ㅋㅋㅋ	FALSE
역겨운것 들 그동안 불쌍해서 안 쓰던 방 내어 줬다 나가 달라 하니 칼 들 안방 내놓으라 하네	FALSE
공부 해서 공채 들어 가유 ㅡ	TRUE
애시 당초 하이패스 모두 도입 말 문 대통령 비정규직 제로 선언 자극받아 무리하는것 아닌가 자동화 사라지는 일 무슨 억지	FALSE
하이패스 보급 인력 점점 더 필요 없어질텐데 어쩌겠습 맘 이해 합니다만 하루 빨리 다른 일 찾는게 낫 않을까요	FALSE
앞 톨게이트 직원 필요할까 요 지금 거의 하이패스 답답하네요	FALSE
요즘 하이패스 인해 톨게이트 수납 원 필요없는 시 댄데 흐흐	FALSE
저 거 할 노력 공부 해서 공무원 시험 치세요 깨 리틀 개 나소 정규직	FALSE
효 지 룰 들 하고 있다 가족 들 부끄럽지도 않나	FALSE
어차피 자동화 대체 할 직종 임 직 고용 문제 아님 있는 수납 원 들 잘리게 되있음	FALSE
지금 프로 무인 톨게이트 가능한데 일부러 안 있어요 사회 적 혼란 땜 안 있어서 그렇지 시간 문제 언젠가 없어질것 확정 직업 가지 더 내놔라 정규직 시켜내라고 악 다 구 치면 더 빨리 소멸해 버리겠죠	FALSE
미친 이 노력 장사 해도 대박 나겠다	TRUE
은행 힘들게 들어갔으나 시대 이러하니 퇴 출되 잖아요 시대 역행 할 순 없을것 같아요	FALSE
아 별 미친 편의점 정규직 바꿔야지 그럼	FALSE
노력 하기 싫고 인생 탓 하면서 쌩 떼쓰지말고 시험 바서 들어가라 톨게이트 가면 하는 일도 없으면서 힘들고 어려우면 다른 직업 찾으셈 하이패스 좋은데	FALSE
이 것 한계 례 쓰레기 집단 차라리 북한 가서 기사 써라	FALSE
참 별 짓 다 하네	FALSE
대모 다 고 정규직 시켜주면 개 나소 대 모 만하 겄 다 나라 참 거 시기하네	FALSE
그냥 추방 시켜라 특권 바라네 노력 없이	FALSE
그러지말고 개돼지 들 세금 더 올려서 일자리 만들어 줍시다 세금 바치는건 개돼지 숙명 이	FALSE
아니 하이패스 다 달 다니는 세상 언제 저럴려고 집어치고 딴데 알아보세요 누가 밥 떠주기 기다리지 마시고	FALSE
오 체 투지 육체 투지 간 문제 이 사람 들 쓸모없는 인력 것 동 네 사람 중 사지 멀쩡하고 한국말 할 ㅈ ㄹ 아는 사람 이면 누 구나 가능한 일인 수납 원 이제 하이패스 쓸모없는 존재 되었는데 몇 십년 간 잔돈 바꾸는 일만 해온 사람 도대체 무슨 일 새로 가르쳐서 시킬수 있겠나	FALSE
나라 꼴 참	FALSE
법위 있는 이강래 배임 조사해 정부 나서서 사회 규율 지켜라	FALSE
도로공사 핵심 업무 톨게이트 이뤄진다 도피 아가 사장 있는 외주 업체 하이패스 관리 마찬가지 공공기관 실태 이러니까 청년 들 갈 곳 없어지는거다	FALSE
길 바닥 누우 정규직 되는거여	FALSE
대법 판결 승소 대량 해고 당하고 원 직 복직 안 시켜주고 삽 질하란다 기 막혀서 길 바닥 누우 다니는거다 간 임금 착취 공기업 나라 법도 무시 하니 거리 나서고 있는거다	FALSE
하고싶은 일만 하면서 공기업 직 고용 해달라고 진짜 바닥 드러누웠네요 판결 난사람 직 고용 해줬다던데 저런다고 해주는 정부 드러눕는 어른 들	FALSE
판결 사람 직고 용했다던데 모든 공기업 다 하는 순환 근무 거부 한다고 저러는건 가요 아직도 특혜 더 바라는 건지 이번 뭔 가요	FALSE
진짜 청와대 뭐 있는지 궁금합니다 저 들 정당함을 하루빨리 결정 죄 지은 사람 감옥 가고 법대 해야 됩니다	FALSE
삼성 엘지 유럽 시장 발도 내딛지 못 할 때 유럽 도전 했던 거인 내 초반 유럽 갔을 때 특히 동유럽 삼성 엘지 몰라도 대우 알 정도 였음	FALSE
김대중 대우 더불어 대한민국 팔 먹었지	FALSE
김대중 김우중 인생 망쳤다 김대중 대우 파산 시켰다	FALSE
세계 넓고 도망 다닐 곳 많았다	FALSE
뭐 알 이런 말 하는지 김대중 정권 시절 지원 안 해줘서 부도 난건 누구 아는 얘기 김우중 회장 도망친것도 아닌데 뭐 분식회계 뭐 이런 이수 있었지만 대우 망한건 우리나라 발전 퇴보 시킨것 같다는 내 뇌피셜	FALSE
coco 니 님 말로 뭘 고 댓글 쓰셨 남 퇴보 과장 심하다	FALSE
분식 를 넘게 쳐 박아 놓은 기업 지원 무슨 지원 ㅋㅋㅋ 역사 남 사기꾼	FALSE
김대중 이 대우 팔아서 그 돈 노벨상 사닸	FALSE
추징 금 는 어따 묻어 놨으려	FALSE
세계 향 하 사기치다 나라 말아먹은 놈 imf 의 원흉 죽 때 돈 안 갚도 뒤짐 ㅉㅉ	FALSE
책 전체 다 소설 건가 최초 신부 님 김대건 안드레아 이십 니 이승훈 첫 신부 라고요 아닙니다 ㅠ	FALSE
식자 배신 그동안 다산 정약용 행적 너무 미화 되었다는 게 이제야 조금씩 드러나는구나	FALSE
누구 나가 김우중 신화 기억 다 대 대였던 우리 아빠 김우중 회장 보며 나도 할수있단 꿈 꾸던 시절 이었다한 다 우리 아빠 회사 몇 년 다녀서 모은 돈 조그마한 공 장하나 세 얻어서 기계 대 들여다가 사업 시작 해서 공장 먹고자고 해가며 제 의 김우중 꿈꾸며 힘든 시간 버텨 냈다 함 나이 서른 되 기전 집사 차사 결혼 할아버지 가게 차려 드리고 똑똑한 막내 동생 유학 보내주었다한 다 김우중 회장 단순히 성공한 기업인 아니라 그 시절 젊은이 들 희망이 였다 그리고 문 재앙 현 시대 청춘 들 재앙 이 절망	FALSE
결국 김우중 실패한 사업가 아닌가 주먹구구 식 무리한 사업 확장 분식회계	FALSE
이런 의식 때문 올바른 한국 만들어질수 없다 영원히 가 진자 들 종 사는게 편하고 올다고 생각 하 ㅉㅉㅉ	FALSE
국내 역대 기업인 중 가장 존경 할 수 있는 분 꼽으라 김우중 회장 만 분 또 있을까 재벌 회장 들 있는 그 흔한 혼외자 스캔들 한 번 없이 오로지 일 매진 분 명절 날 현장 상주 오지 일 하는 직원 들 찾아가고 밤 늘 일만 하던 회장 님 그런 회장 님 이제 다시 만날 수 없다	TRUE
우리 땅 모든 의식 맴돌던 시절 세계 우리 의식 안 끌어 들여 준 일 외국 나가면 움츠러들던 시절 외국 우리 당당하게 일 할 수 있 음 보여준 개척 자	FALSE
루 매니아 인도 폴랜드 중국 이 되 기전 세계 곳곳 함께 하셨던 열정 기억 하고 젊은이 들 도전 길 열어 주셨던 혜안 깊이 감사 드립니다 실퍠 기업인 아니라 이나라 성장하는 과정 함께 했던 큰 별 이십 니	FALSE
대우 망한건 정부 구제 안 해줘서 가 아니라 분식회계 독자 적 기술 발전 무리한 인수합병 표면 적 실적 의존 했고 빚 많아 서지 뭔 정치 탄압 그 말 김우중 회장 말 한건데 추징 금 내 고해 그 말 믿는게 이상하다	FALSE
이 놈 빨갱 싸가지	FALSE
얼굴 가래침	FALSE
핵때 중 때문 회한 세월 보내시다 이제 근심 걱정 없는 하늘나라 편안히 영 하세요	TRUE
세상 넓고 분식회계 많다	FALSE
분식회계 주 범 추모 하다니 ㅋ	FALSE
김대중 이 국가 경제 한 축 아작 낸 사건 다름없는 짖을 대우 그룹 직원 길거리 내 쫒고 군산 내몬 현재 대우 아닌 대우 국민 혈세 축 낸 자가 더불어 민주 노조 및 김대중 일부 국민 알것이다 김대중 업적 햋빛 정책 마누라 을둔자가 평화상 받고 카지노 설립 및 후진국 볼 로또 전 국민 놀음 판속 집어 논자 더불어 꼴통 민주당 노무현 또한 같은 자로 그 들이한 업적 남긴 족적 봐라 남은게 있는가 무조건 편 만들지말고 업적 놓고 봐라 어른 들 경 부선 경인선 고속 화 때 드러눕던 김대중 김영삼 인정 박정희 현재 일부 좌파 하는	FALSE
범죄자 새끼 왜 추모 하나	FALSE
세계 넓고 할 일 많다 이 한마디 모든 것 들어 있습니다	TRUE
미국 중국 견제 하 듯 유태 자본 세력 일본 견제 멍청히 당하지 않았다면 주가 은 됬을듯	FALSE
무리하게 사업 확장 하다 이 거저 거 말 먹고 직원 들 고통 안겨주고 떠난 사람 너무 찬양 들 하시네	FALSE
와 ㅋㅋ 댓글 장난 아니네 분식회계 한 사람 훌륭하다니 한두 푼 아니고 나라 휘청 할 돈 이었는데 대우 부도 인해 자살 하신 사 장님 들 명복 빕니다	TRUE
정경 유착 분식회계 졸 부가 된 사람 명복 빌어줄 필요 없습니다 김우중 인 인간 가면 쓴 늑대 입니다 기업인 무슨 부끄러운줄 아십시요	FALSE
고인 명복 빕니다	TRUE
대 중이 사람 하나 지대 망쳣엇	FALSE
대우주 해와 달이 번갈아 뜨는 육대주 오대양 우리 들 일터 우리 대우 가족 한집안 식구 온누리 내 집 삼아 세계 뻗자 아 이제 전설 같은 대우 가족 사가 입니다 회장 님 고생 많이 하셨습니다 평안하게 영 하시고 하늘 큰 별 되어주세요 감사합니다	FALSE
명언 세상 넗 할 일 많다 창조 도전 희생 삼가 고인 명복 빕니다 하늘 나라 김대중 싸대기 갈기 십 시 문재인 그 일당 더불당 들을 저주 하여 주 옵서요	FALSE
김 우중 회장 님 그 곳 서 행복하세요 삼가고인 의 명복 빕니다 대우조선 해양 큰 별 떨어 젔 네	TRUE
삼가 고인 명복 빕니다 세계 경영 개척 깃발 를 높이 들 전진 하는 늠늠 호랑이 위상 일 깨워주시고 젋 이 들 희망 주신 고인 멀리 나마 명복 빕니다 그릅 해체 후 제기 하여 과거 다시 살리 시기 염원 했는데 끝내 이루지 못 한것이 안타깝습니다 당시 정권 대중 경제 정치 풀면서 그 릅 해체 당하시고 평생 일궈놓은 회사 헐값 외국 기업 넘어가 지금 정상 궤도 진입 못 구설수 오르는 등 안타까운 현실 반복 되고 있는 현실 정권 경제 망치 않는 그런 세상 영 하시길 바랍니다 당하시	TRUE
지옥 도요타 다이쥬 센 센와 리벤지 매치 뜨시겠군요 화이팅	FALSE
고인 명복 빕니다	TRUE
고인 명복 빕니다	TRUE
죽기전엔 통큰 사 깃굿 소리 하구 정권 입맛 데 기업 죽이 더 죽으니 뭐라고 들 지껄이네 인생 무상	FALSE
명과 암 분명했지만 이렇게 또 한시 대의 영웅 떠나가네요 요즘 시대 보기 어려운 DNA 를 가졌던 분 삼가 고인 명복 빕니다 🇰🇷🇰🇷🇰🇷🇰🇷🇰🇷	TRUE
한시 대의 큰 족적 남기신 분 영원히 기억 되길 돌아가시면서 대한민국 얼마나 걱정 하셨는지 상상 갑니다 편안히 영 하시길 바랍니다	TRUE
고인 명복 빕니다 나라 발전 이바지 하신 공로 잊지 않겠습니다	TRUE
대우 빌딩 엘리베이터 종종 뵈어도 언제나 소탈 하시고 체면 치레 격식 없으셨던 분이시지요 남 들 뭐라 할 지 모르겠으나 일 대한 열정 집념 그리고 도전 의식 과 히 남달랐던 분이셨지요	TRUE
일찍 세상 떠난 장남 만나시어 그동안 못 다한 부자간 정 나누시길 기도 드립니다 대우 일 할 기회 주신 회장 님 감사 드립니다	TRUE
삼가 고인 명복 빕니다 의 우리나라 뿐 아니라 전세계 영웅 이었습니다	TRUE
국가 경제 발전 많은 공헌 하신 분 입니다 말년 원조 빨갱이 개대 중 잘못 맞나 고생 많이 하신게 아쉽습니다만	TRUE
삼가 고인 명복 빕니다 분명 이 나라 발전 뛰어 다녔던 분이였고 그 마음 이 위태 지금 이 나라 지켜 주십시요	TRUE
김우중 회장 님 편히 가시기 바랍니다 ㆍ 명복 빕니다 ㆍ	TRUE
대 중이 놈 없었으면 대한민국 대장 있었을텐데	TRUE
이헌재 용서 구하라	TRUE
다음 생 기업인 존경 받는 나라 못 다한 꿈 이루시길	TRUE
우리 들 신 화이자 우상 이십 니 존경 하는 분 떠나셨네요	TRUE
문 주 당 없애고 있다 부들부들	FALSE
부디 영 하시길	TRUE
분식회계 정부 뒷 배 성장한 대우 그룹 국가 적 폐 왜 추모 하지	FALSE
IMF 핑계 김대중 제 눈 난 기업 싸 그리 난도질 해서 많이 도 죽였지 그중 대우 그룹 가만히 두었으면 지금 삼성 더 훌륭한 대한민국 대표 기업 전세계 주름 잡고 국위 선양 했을것인데 너무 안타까운 일이	TRUE
핵 지팡이 핵대중 대우 공중 분해 시켜 버렸지 대선 때 양 측 다 정치 로비 했어야 했는데 핵대중 상대 측 섯다 이유 정말 대우 그룹 살 있다면 오늘 랄 삼성 현대 처럼 세계 글로벌 기업 됐을텐데 아쉬움 크다	TRUE
만나지 마세요 속 터지니까 요	FALSE
못 만나요 그 분 지옥 계실거니까	FALSE
너 혼나야겠다	FALSE
힘들 엇 던 세 상사 잊으시고 편히가십시요 많은 사람 도움 주시 하늘나라 그 복 다 받으시고 사랑 합니다 회장 님	TRUE
그건 무슨 개 논리 부채 많아서 망한 회사 뭐 어떻게 하라 나랏돈 빚 갚아 주 ㅉㅉㅉ	FALSE
국가 추징 금 날라 간겨	FALSE
고생 많이 하셨습니다 김우중 인해 감사합니다 잊지 않겠습니다	TRUE
남 돈 분식회계 범죄자 빨아주는 개돼지 나라 대를 멸족 해도 모자랄 범죄 두둔 하네 니 들 재산 세금 나 줘 바라 어떤 멍청이 남 돈 일자리 수십만 개 만든다	FALSE
진짜 아무 것 모르는 사람 들 정말로 많구나 고 김대중 대통령 김우중 먼 상관 임 대우 빚 얼마 였는 알기 나하 댓글 남기는거 임 분식회계 얼마나 해쳐 먹은줄은 알고있음 그때 내기억 생생함 대기업 부도 났으면서도 우리 경제 충격 최소 화했다 그때 만약 박근혜 였다면 그건 진짜 국가부도 날 정도 였음 장담 함	FALSE
세금 미납 는	FALSE
고인 죽음 애도 합니다 하지만 국민 경제 말아먹고 도피 사람 이렇게 언론 생각 없이 키우는 기사 버젓이 내는 건 못 배워서 입 고의 입 김우중 씨 죄 어디 간 겁	FALSE
회사 돈 횡령 회사 망하게 한 주주 배신 반 자본주의자 요새 기업가 하나	FALSE
대 중 우 중 진실 뭐	TRUE
세모 유벙언 부채 탕감 기준 이면 베트남 하노이 땅 안팔 지금 베트남 엄청난 기업 진출 했을텐데 쩝쩝	FALSE
그래서 벌금 세금	FALSE
우리나라 언론 정말 미친 것 같아 추징 금 얘기 일도 없어 ㅋㅋㅋ	FALSE
추모 세상 둘 없는 국민 사기꾼 한 데 왜	FALSE
고인 명복 빕니다 어찌 됐든 지금 대한민국 일조 하 신분 아니겠습니까	TRUE
정권 희생 된 대우 아쉽다	FALSE
김대중 이 죽인 기업 중 대우 한 곳 이였지 대우 한국 보다 외국 아아 주는 기업 이였지	FALSE
잘 가라 곧 지옥 행 특급 열차 타겠구만 ㅋㅋㅋ	FALSE
고생 하셨습니다 삼가 고인 명복 빕니다	TRUE
슬프네요 회장 님 회사 쓰러지면서 그 아픔 마음 달래면서 지나 왔을텐데 회장 님 존경 합니다 당신 기억 하겠습니다	TRUE
하늘나라 못 다 핀 세계 경영 꼭 이루십시요	TRUE
한세대 풍 미하셨으니 여한 없으시겠죠 편히 잠드세요	TRUE
삼가 고인 명복 빕니다	TRUE
능력 무한 한 데 날개 무참 히 꺽 어 버린 정권 편안히 영 하세요	TRUE
수고 많으셨습니다 ㆍ 영 하세요	TRUE
김우중 회장 님 고생 많이 하셨습니다 극락왕생 하시길 간절히 기원 드립니다	TRUE
고인 명복 빕니다	TRUE
그렇게 김우중 비판 하더니	TRUE
삼가 고인 명복 빕니다	TRUE
삼가 고인 명복 기원 합니다	TRUE
Dj 가 대우 망친겆 머	FALSE
핵대중 뇌물 현 문 재앙 지옥불 타 죽을거다	FALSE
핵대중 희생양	FALSE
저 인간 때문 우리 집 망했었는데	FALSE
죽으면 끝 멀 자꾸 띄어 뒈지면 구 데기 꼬여 흙 변함 죽 때 거지 억만장자 똑같어	FALSE
남 비난 싶으면 사실관계 알 댓글 써라 IMF 는 일어났고 그해 금 모으기 운동 일어났다 대우 그룹 부실하던 쌍용차 인수 하여 김 회장 판단 미스 쌍용차 적자가 대우 그룹 전체 흑자 비슷해지고 환율 이자율 폭등 최종 워크아웃 들어가 대우 그룹 망했다	TRUE
회사 망하게하고 세금 내기 싫어 도피 한 분 아닌가 뭐 마지막 길이 배웅 하는거야 상관없지만 위인 다루듯 하는건 오버 아님 대우 망하고 우리나라 타격 컸는데	FALSE
못 뵈 엇 지만 가슴 아픕니다 너무나 ㆍㆍ 대우조선소 대우전자 대우 특산 코람 플라스틱 오리온 전자 대우자동차 기타 ㆍㆍㆍ 많은 곳 종사 하 신분 들 기업 그렇게 되 고다 들 고생 하시고 마음 아파 햇 는데 또 이렇게 돌아가시고 기업 분산 없어지기까지 무엇 회장 님 마음 고생 해드린게 없어서 죄송합니다	TRUE
결국 양 정철	TRUE
그러니까 청탁 사실 소리 넌 안 들어줬지만 누군가 들어줬다는 말	FALSE
헐 국민 들 대출 받기가 얼마나 힘 너 아냐 빚 지고 있는 개인 대출 해줬는데 미치고 돌아 그 은행 대통령 표창 장이 붙어 있어 뭔 개 소리	FALSE
원래 애 들 불리하면 남한 떼 뒤집어 씌우는 전형 적 방법 정치 믿지말아라	FALSE
국정 농단 직권남용 핵폭탄 급 사건 연속 적 터지고 있다 적폐 청산 독재정 권 문재인 정부 윤석열 검찰총장 철저히 수사 해서 낱낱이 국민 들 밝혀야 할것 입니다	FALSE
제보 하는 저 여자도 문제 있는게 아니야 처음 문 빨하면서 온갖 혜택 받았잖아 그런데 이제 서 마치 자기 엄청 ㄲ 끗 희생양 하는게 처 ㅓㅁ	FALSE
우리들병원 특혜 반드시 빠른 시 일 내 철저한 조사 이루어져야 할 중대한 사안	FALSE
과연 그럴거라 믿어줄거 같냐 이 드러운 뇸	FALSE
드루 킹 텔레그램 나온대로 문 재앙 포함 정부 주요 인사 들 카톨릭 예수회 밀접한 관련 있는게 맞는 건가	FALSE
양 정철 철저하게 조사해 공직 맡지 않은 최 순 실 한 일이 죄 되고 그 방치 했던 대통령 탄핵 당하여 구속 되어 있는 것 바례하 아무런 공직 맡지 않은 양 정철 그 훨씬 더 큰 사고 개입 되어 있다면 당연히 그 상응 하는 조치 있어야 한다	FALSE
서울 구치소 정리 리 모델링 해야 한다 조만간 문재인 정권 실세 들 줄줄이 엮일 모양 이광재 비롯 해서 그 하수 윗 대가리 등 태양광 사업 하는 인간 스마트 도시 건설 설계 하는 놈 들 등	FALSE
이 놈 삶은 개 대가리	FALSE
지랄 자빠졌네	FALSE
딱 면상 사기꾼	FALSE
느그 들 병원 문재인 대선 자금 줄	FALSE
내 가볼 땐 신혜선 씨 사기 당한것이고 우리 들 병원 특혜 성 맞다 양 절철 씨 주장 다르다	FALSE
여기 기 사 내용 보면 잘 모르고 유재일 유툽 채널 김경 율 회계사 김봉수 교수 전 판사 해당 건 신혜선 씨 직접 인터뷰 내용 분석 한 거 있더 만요 이후 https://www.youtube.com/watch?v=Y2tA0_vkHmE https://www.youtube.com/watch?v=nEBDjEhDyXI	FALSE
불법 저지른 자를 색출 하	FALSE
신혜선 씨 내 가볼 땐 사기 당 햇더	FALSE
이 기사 핵심 마지막 줄 기사 잘썼네 ㅋㅋ	TRUE
이자 식이 노무현 정권 때 문화 부 국장 배 째준다고 막말 했던 막가는 놈 아니었나요	FALSE
양원 장도 신속히 조사해 야한다	FALSE
양 정철 문자 쓰며 길게 대답 하는 꼴 마치 도둑 질질 들킨 도둑 놈 발 저린 꼴 그 행세	FALSE
국정 농단 적폐 세력 들 거의 다 잡혀 가는구나 최종 보스 잡 때 슬슬 오네 문재인 아웃 D	FALSE
역대 최악 독재정 권 문재인 정부 뻔 뻔하고 저 질 좀비 들	FALSE
정철 그럼 고소해라 명예훼손 너 것 들 언제 대인배 였니 나 뿐 넘 들	FALSE
문씨 측근 멀 정 한 사람 찾아보기 힘드네 끼리끼리 측근 정치 하니 비리 많지 철저히수 사해	FALSE
청탁 안 들어줬는데 그럼 은 누구 청탁 대출 해줬길래 요 말 앞뒤 안 맞냐 이생 퀴 양	FALSE
사기꾼 들	FALSE
똘똘뭉쳐 온갖 비리 투성이 거짓 당 구속 하자	FALSE
국정 농단 텔레 그램 문자 증거 어쩔 거여	FALSE
이 사건 관련 된 천주교 일부 인사 들 그리고 민주화 위장 종북 단체 정의구현사제단 등 정치 적 중립 저 버리고 문 통 지지 하는 특정 지역 편향 태도 방송 해대 있는 것 주님 뜻 거리 먼 종교 기본 적 양심 저 버리는 행위 종교 이념 투쟁 장 만들면서도 북한 인권 종교 자유 문제 의도 적 외면 하는 나쁜 선례 보여주고 있어 종교 지도자 들 자아 비판 양심선언 필요하다	FALSE
자살 할지 모르니까 일단 구속 해라	FALSE
쌍거풀 수술 이미지 세탁 뻔뻔스럽다 솔직해라 양씨 어깨 힘주고 설치더니	FALSE
국기 문란 헌법 파괴 반 민주 세력 문재인	FALSE
이 새끼 들 입 열면 거짓말 하는것 들이 상식 적 돈 없어 연대보증 까지하는 놈 천사백억 대출 이 정권 아니면 가능 하냐 정귄 잡아다고 은행 경찰 모든 것 저희 맘대로	FALSE
그럼 들어준 청탁 뭐 있냐 ㅋㅋ 반 대 급부 조사 해보면 답 나오지 않겠나 ㅋㅋ	FALSE
아직도 좃선 일보 기사 믿는 사람 있냐 있다면 꼴통 들 이겠지 ㅋ ㅋ ㅋ	FALSE
이 것 드루 킹 일당 대해 김경수 했던 변명 똑같네 ㅋ 좌파 들 레파토리	FALSE
변태 생겼다 싶었는데 하는 짓도 변태 저러니 문 재앙 같이 놀지	FALSE
말 그렇게 하면 않 되는거지	FALSE
이 넘 들이 공 수 처 그렇게 주장 하는 이유 비리 들어나서 감옥 갈까봐	FALSE
역시 친 매국 조 옷선 방가 일보 기사 군 이런 기레기 기사 올리는 네이버 폐간 대 상임 반드시 깨 시민 민주 진영 니 들 용서 하지 않을것 임 나라 도움 안되는 기사 올리는 아베 홍보	FALSE
신혜선 좌파 정권 탄생 크게 도와주고 완전히 토사 구 팽 당했네 이바 닦은 원래 그래 문 재앙 양 ㅈ ㅊ 지옥불 떨어질 놈 들 부메랑 되어 돌아 갈것이다	FALSE
밑 끝 없이 그냥 청탁 한 건 아닐거 아니냐 받아 처 먹은게 있으니 그 대가 치르라고 하는거지 ㅋ	FALSE
좌빨 믿고 건물 보증 선 강남좌파 아줌마 꼴 보기 좋다	FALSE
이 정권 실세 대상 청탁 안 들어주자 서운해서 하는 주장 이런 말 믿어줄 사람 문 대통령 지지 하는 세력 뿐이겠지 그 들 콩 팥 해도 믿을거니까	FALSE
니 말 대루 해결 청탁 허자 근데 분명한 건 너 그 넘 들이 집권 하기 전이 후 해결 요청 했던 건 똑 같은 사실 집권 전 미래 약속 집권 후 청탁 이 넘아 여하튼 이런 넘 들이 더 더 러버 내 신혜선 두 뻑 치겠다	FALSE
냄새 풀풀 나는구나 적 폐가 따로 있나 이런 것 적폐 한다	FALSE
문재인 정권 놈 들 정권 잡자마자 한몫 챙기는데만 몰두했네 반 이렇게 더러울수가 있나 조국 김 의겸 손 혜원 양 정철 셀 수도 없다 더러운 정권 카악 퇴	FALSE
양가 놈 백수건달 이었던 때 금감원 장 인사 일정 알았다니 내 보기 이상호 부실한 병원 살리기 위 해서 문 놈 대선 자금 쓰였을 거 같어 물론 병원 운영 자금 쓰였겠지만 액수 되게 크잖아 양 정철 윤규 근 이런 애 들 왜 중재 나섰 갰어 돈 얽혔으니까지 희 정이 마냥 징역 가라	FALSE
안 들어 준건 너 싸가지 문제 ㅡ 청탁 할만큼 전 무슨 코 꿰었는	FALSE
예전 깡패 들 등 쳐 먹었다만 지금 합법 적 국민 들 등 쳐 먹는 정치 꾼 들 더 추악한 것 지금 여권 실세 것 들 과거 민주화 운동 했다고 더 설치 등 쳐 먹고 국민 들 죽어 나자빠져도 꿈쩍 하지 않는 도대체 이 라나 공 의 정의 바로 세워질 수 있을까 아니면 이대로 망해 버릴까	FALSE
입 오르내리기 시작 하면 사연 있겠지 앞 벌어질 일이 궁금해지네	FALSE
도대체 이 것 들 말 신뢰 도 없으니	FALSE
양 정철 한국 외국어대 법학과 학번 생 정철 자네 친구 승훈 이제 몰락 중 달 문 통령 배 어여 뛰어내려라 손절 최선 어차피 중에 문 통 큰 일 치를 일 생긴다 류 동학 인문 명 리학 자 예언 지금 예언 적중 대 국정 농단 사건 우리들병원 불법 대출 유재수 감찰 무마 건 김기현 부정선거 부정선거 이후 최악 정권 실세 부정 이 문죄인 정권 나락 떨어지게 할거다 충고 잘 받아 드려라 친구	FALSE
도데 체 이자 아무런 직함 없던 시절 국정 농단 인사 개입 정책 결정 다 했단 말 이런 자가 찐 짜 더 큰 비 선실세네요	FALSE
이번 정권 청와대 인사 들 좌파 유력 인사 들 대부분 악취 풍기는 비리 착복 개판 난장판 이군 그러게 왜 판핵 하고 문 죄 앙이를 찍었나 차라리 홍준표 찍었더라면 이런 최악 없었을텐데 말 온통 빨갱이 천국 좌빨 세상	FALSE
저 무리 들 빵 는 모습 온 국민 지켜보자	FALSE
범죄자 전원 구속 하	FALSE
문씨 파 들 끼리끼리 다해 쳐 드셨구만	FALSE
이 xx 이 거 정체 뭐	FALSE
겸손함은 찾을수 없고 철인 적 화대 인 회의 실세 인방 바 그네 비 선보다 더 한 눔들 이런 눔들 나라 망하게 할 눔 들이다	FALSE
이 놈 미국 돌아올 때 공항 사진 보 머리 발끝 명품 도배 프라다 가방 매고 있더만 자칭 진보 좌파 놈 개 졸부 양 아치 더군 공식 직함 없이 지낸 모사 꾼 무슨 돈 그리 호강 하실까	FALSE
이 천벌 받을 놈 들 너희 들 자손 대 주홍글씨 새겨 넣을것이다 이 년 누구 딸년 이 놈 누구 아들 놈 대한민국 유린 국민 들 편 가른 죄 꼭 그리 할것이다	FALSE
간첩 세 끼 후안 무치	FALSE
제목 그렇게 말 해야 겠지	TRUE
슬슬 하나 씩 터져 나오는 것 보니 이 정권 레임덕 시작 되고 있는 건가 유	FALSE
친노 친문 인사 전국 최고 더러운 모사 꾼 사기꾼 구라쟁이 살인마 빨갱이 들 집합소 이제 온 국민 들 다 알 있습니다 너 그 중 하나 즐	FALSE
추잡한 친문 세력 들 적폐 중 적폐 집단 도대체 이 적폐 집단 말 거짓말 나중 다 밝혀질 것 이리 거짓 일관 하는가 나라 망하려나 이런 추문 지지율 미치지 않고서는 정의 어디 갔는가	FALSE
별 쓰레기 같은 것 들 날뛰네 조용히 좀 찌그러져라 자 한당 패거리 들	FALSE
살 오면서 확실한 직업 없이 정치권 기웃 거리 유력 정치인 줄 서기 잘 해 폼 잡는 씨레기들 많다	FALSE
친구 니 가라 깜빵	FALSE
얼굴 봐도 누가 돈 먹었는지 각 이나 오네	FALSE
이번 정권 사람 들 하나같이 오리발 장 착했네 어휴	FALSE
좌파 들 좀 처 내자	FALSE
양 정철 한국 외국어대 법학과 학번 생 정철 자네 친구 승훈 이제 몰락 중 달 문 통령 배 어여 뛰어내려라 손절 최선 어차피 중에 문 통 큰 일 치를 일 생긴다 충고 잘 받아 드려라 친구	FALSE
별거 같은데	TRUE
이 짝눔 들 다 이용 해 쳐 묵고 들통 나면 내 언제 나 아니야 하면서 빨 뺌에 도통 것 들 그러다 하나 둘 씩 사실 확인 되면 마지못해 밝혀지는 것 인정 양심 이란 전혀 없는 종자 들	FALSE
자칭 좌파 너 어 ㅁ 들의 맨 얼굴 조국 부터 잘 보여주고 있어 니 들 적폐 몰랐다	FALSE
생긴것도 영 아치 스럽다	FALSE
별 똥 같은 것 들 개폼 잡고 지랄 하고 다니네 좌빨 스키 들	FALSE
쓰레기 들	FALSE
원래 큰 시 건 이렇게 시작 합니다	TRUE
라이 이제 너 패거리 말 들 콩 메주 쑨 다해 못 믿는다 하나같이 다 썩어 빠진것 들이고 양심 있는것 들은 하나 없네	FALSE
필체 힘 넘치는것 보니 남성 필체 것 같은데요 김수경 남자 양 정철 씨 대답 해보세요	FALSE
요즈음 뉴스 전부 청와대 핵심 실세 비리 건 누구 하나 입 벌리면 사상 누각 패 이 구먼 레임덕 징조 저 관여 한 게 없 습 네 저 모르는 일이구 저 그 사람 얼굴 전번 없는 디 그건 음 해구요 저희 DNA 는 질 다르답니다 묵비권 행사 합니다 휴대폰 개인 사물 압수 하면 안 돼죠 영장 발급 되었나요 나쁜 ㅅㅐㄲ ㅣ 들 태양광 월매 해 쳐 묵었을까	FALSE
누구 하나 입 벌릴려고 하면 자살 당하죠	FALSE
대출 금도 경매 들어가다가 중단 된 채무자 어떻게 국책 은행 을 대출 했는지 부터 밝히는게 순서	FALSE
전화 녹취록 등등 증거 수두 룩 빽빽 있는데도 끝 좌빨 들 목적 달성 위 해서는 거짓말 악질 적 좋다고 믿는다	FALSE
나중 다 깜빵 간다 거짓말 작작해라 더러운 좌빨 들	FALSE
양정 개 기름 줄줄 어찌 문 빠 들 정권 잡고 모두 개 기름 좔좔 흐르냐	FALSE
그래 청탁 안 받아 준 것 잘 했다 본질 너 네 들 돌아가면서 그 여성 살살 달래는 이유 대출 커미션 먹었니	TRUE
저 년 자기 대조 천주교 원로 조상 팔 선동 해 천주교 문 재앙 열 열 밀어 줬지 ㅋ 천주교 망국 종교 만든 쓰레기 돈 문제 걸리니 또 문 재앙 욕 하네 ㅋ 기회 주의자 늙은 년	FALSE
민주 연구원 장 도 대처 뭐 하는 곳	FALSE
사기 도둑질	FALSE
이제 곧 진짜 구린내나는 인간 들 적폐 청산 할 차례	FALSE
어찌 문제 많은 인 간 주위 어찌 다 들 문제 많은 인 나 들 뿐 으 휴 최 순 실 이 것 들 비함 암 것 아니였네	FALSE
말 안되는 개 소리 양정 철도 시작 하는구나	FALSE
천지 사기꾼 쉑히들 전부 진보 간판 걸고 왠 갖 추집 짓은 다 다니는구나 양 아치 같은 놈 들	FALSE
좌파 특징 피아 구별 확실하게하고 진영 이 다른사람 무조건 적 폐 몰아 붙이 뒤 온갖 더럽고 추악한 일을하는 서슴없이 하는 새끼 들 나 이명 박근혜 정권 욕 졸라 많이 했었는데 미안 앞 좌파 들 표 줄일 없다	FALSE
살이 쪄서 얼굴 탱글탱글하다 국민 혈세 쥐 새끼 도둑질 해서 빼 쳐 먹고 깜빵갈 날 머 않았다	FALSE
문재인 대통령 옹립 시킨 재수 회 맴버 양 정철 비롯 명의 철로 끝나는 자 들 있는데 문재인 대통령 밑 문 제 덩이 일 있다고 소문 돈 다 권력 마구 휘두르고 조국 지키기 운동 하고 참 안 엮 이는데가 없네 실세 더니	FALSE
자기 들 과 도움 받는게 당연한듯 생각 하는게 문제 제대로 각 잡고 보면 정치자금 법 위반 소지 농후 할텐데 받은것에 대한 죄책감 없고 공짜 안도 왔다고 악의 적 후원자 취급 하는 좌빨 클라 쓰	FALSE
양 정철 그럴줄 알았지 빈손 먹을라 구 더러운 좌빨 대 깨문 새끼 들	FALSE
오 홍 이제 드디어 언론 우리들병원 슬슬 나오기 시작 하는구만 신혜선 완전 다 진실 들 폭로 할거라고 하던데 이제 양정 철도 도망갈 구멍 없을 것 같다 연루 된 건 빼박 못 하는 진실 이자 사실 팩트 양 정철 아무 것 연루 된 게 없을 것 같나 다 연루 되어 문제 중심 서 있을 수도 있다 양정 철도 조사 하면 뭔가 나올 걸 검찰 엄청 바쁘다 너무 조사 수사 할 게 많아서 뒷돈 받고 겉 깨끗한 척 아무 것 잘못 없는 척 가면 쓰고 있는 소시오패스 들 자기애 성 인격장애 나르시시즘 소시오패스 들 빨갱이 들 특징	FALSE
오호 이전 뭔가 들어주고 받았다는 이야기 구만	TRUE
크 흠 이 거 덧글 조작 깜방 가셨던 김 모씨 하시던 주장 ㅋㅋㅋㅋㅋ	FALSE
팟빵 http://www.podbbang.com/ch/4362 대우 김우중 특집 들어 보세요	TRUE
대우 김우중 대한 팩트 듣고 싶다면 팟빵 앱 이이 제이 김우중 편 들어 보세요	TRUE
대우 있어 행복했습니다	TRUE
나라 경제 살려 일자리 만들고 수출 한국 제품 튼튼하다는 인식 심어 준 진정한 애국자 회장 님 대우 이렇게 만든 대통령 만배 위대하 신분 입니다 회장 님 우리 청년 들 자신감 갖고 시야 넓혀 세계 시장 우뚝 서기 바라시던 분 지금 삼성 기간 안된 부채 상환 하 하면 몇 천 조로 국가부도 난다 정권 찍히면 이렇게 된다는 사례 한번 뵌 적은 없지만 이렇게 나라 위 한 분 국내 들어올 수 없게 만들었다 작은 규모 회사 분식회계 안 하는 곳 있나 이런 큰 어른 없을거 같아 안타깝다 회장 님 존경 합니다	TRUE
정치인 없는데서 좋은뜾 펼치시며 영 면 하 셰	TRUE
대우 그룹 재 평가 되어야 함 좌파 농단	TRUE
일반 기업 다니는 사람 연봉 에 카드 론 받은격임 그걸 무슨 수로 갚음 재 평가 무슨	FALSE
월계 수회 하나회 정권 합작 키워진 대우 그룹 이 권력 도전 하려고 용 쓰던 정적 들 돈줄 죄 려고 수술 집행 하던 걸 대중 어쩔 수 없이 마무리 휴 자세한건 후에나 밝혀지겠지 아무튼 돌아가신 분	TRUE
모야 이슬람교 인 십분 일도 안되는 유대교 인정	TRUE
나도 선진국 백인 남자 결혼 하고싶다	TRUE
편히 영 면 하 소서	TRUE
노무쿤 안부 전 해줘라 우중 쿤	FALSE
어 이 그 아직 국정원 지하 살아있다구	FALSE
자기 외모 불만 온라인 공격 적 성향 보여	FALSE
김대중 욕 해라	FALSE
김우중 좀 그만 빨아라 쓰레기 들	FALSE
원대한 포부 좋았을지 모르나 문어 발 식 빚 더미 경영	FALSE
무리한 문어 발 식 확장 R D 큰 투자 안 기술 사오는데 주력 자동차 패망 인해 대우 망친 양반	FALSE
은행 빚 잔치하다가 imf 몰 고온 장본인 세금 쳐 먹는 기업 이었다가 쫄딱 쳐 망한 기업	FALSE
분식회계 IMF 의 원인 제공 자	FALSE
뇌물 먹고 죽은 노무현 자살 하면 신 추앙 받고 미화 되는데 왜 기업 정신 투철 했던 자본가 죽어도 재벌 욕 먹는고 돈 많은 놈 들 싫은거 아닌가 ㅋㅋ	FALSE
그 당시 대부분 분식 지금 많이 함 정치 희 새 양	FALSE
잘 한건 잘 했다고 하고 못 한건 못 했다고 하는게 맞는것 같습니다 아무튼 삼가 고인 명복 빕니다	TRUE
유종 미를 거둔 경제 인 였으면 영원히 존경 받았을 텐데	TRUE
그래도 대우 거품 들하지 같은 발주 처 나오는 부품 삼성 들어가면 곱 뛰더라	FALSE
한 인간 명복 빌지만 대 우회 장이 직함 도저히 용서 안된다 이 사람 수만 가족 길거리 내몬 사기꾼 그 이상 이하 아니다	FALSE
가난한 자 부자 결국 가는 것 같지만 한 사람 이 땅 나서 사람 들 애도 속 장례 치루 것 부럽다	TRUE
김대중 까는 사람 많은데 알 깝시 김우중 회장 김대중 절친 이었습니다 당시 나라 부도 났는데 빚진 대우 어떻게 살립니까 대우 망하게 한 건 전 정부 김영삼 맞죠 국가부도 사태 만든 장본인 김영삼 정부	FALSE
김영삼 만들었 다기 국가 금융 지식 수준 이 하였고 아엠 에프 미국 등 갖고 놀기 좋았죠 경 제 발전 하 뺏어 먹을게 맛있어 보였거든요 학 연 지 연등 기업 하는 한국 문제점 보였고 쿡 찔러 알곡 쏙 빼먹은 겁니다 그걸 못 막은 영 삼이 바보 긴 해도 수준 그랬어요 덕분 좋은 시절 다가 잃어버린 여 년 되었네요	FALSE
무슨 영웅 놀이 나라 개판 낸 사람 보고	FALSE
돈이면 그 당시 국가 건설 했겠다 그 돈 이 세계 귀빈 대접받는데 본받아야 된다는게 멀 본받는다는 건지 도둑 너 엄 들 대접받는 세상 씁쓸합니다	FALSE
김대중 때문 참 힘들었지요	FALSE
빨갱이 들 좋아하는 음모론 하 이야기 할게 대통령 각하 기업 들 부채 너무 심각합니다 특히 공기업 부채 심각한 곳 너무도 많습니다 대기업 들 부르고 돈좀 받고 그 기업 들 넘기세요 부채 심해서 아무 안 가져갈려고 합니다 분식회계 하 하세요 당분간 눈감아주고 대출 해준다고 각하 아이엠 에프 대기업 요구 합니다 대우 넘기세요	FALSE
대중 왜 그랬어	FALSE
돈 내 고가 ᆢ	FALSE
삼가고인의 명복 빕니다	TRUE
세상 넒 갈 곳 많다	TRUE
저승 가서 반드시 국민 대신 해서 햅충 친일 망종 요시다 다이쥬 응벌 해주세요	FALSE
죽음 대해 선 안타깝지만 과연 추징 금 낼 돈 없었을까 의문 애도 하기 싫고 저 승가 다 갚아라 당신 인해 수없이 많은 사람 들 힘들었으니깐	FALSE
어쨌든 한 때 대한민국 경제 수장 였습니다 삼가 고인 명복 빕니다	TRUE
좌빨 들 의한 대표 적 희생 자	FALSE
잘못 인정 안 철판 까며 나라 ㅆㅊ 내는건 좌빨 아님 ㅋㅋ	FALSE
먼 개 소리 임	FALSE
나라 안 말아먹어서 그래 좌빨 들 나라 말아먹어서 일어난 일이 짱깨 한글 좀 제대로 배우고 한글 쓰세요	FALSE
분식회계 등 추징 금 쳐 받은 놈 그런 놈 쳐 빤다고 ㅋㅋㅋㅋ 진짜 네이버 댓글다는 븅 god 들은 좌빨 소리 집어넣으면 선동 베댓 들어주네 ㅋㅋㅋㅋ	FALSE
한 때 이병철 정주영 구인회 동 급 이었던 분 삼가 고인 명복 빕니다	TRUE
IMF 가 대우 때문 선동 질하는 사람 들 않던데 국가부도 대우 그룹 전혀 관계 없음 한보 기아 IMF 의 주 범임 대 중이 전라도 기아 살리겠다고 고집 부려서 영 삼이 제때 구조조정 못 해서 IMF 온 팩트 대우 IMF 이후 잘 나갔음 대 중이 집권 후 정작 기아 살리고 대우 죽 팩트 국가부도 원인 기아였고 정작 나중 살린 건 기아 죽여 버린 건 대우 대중 작품	TRUE
이런 개 소리 사람 들 선동 질 싸움 조장 하는거 임 당시 대우 부채 비율 얼마 줄 알 씨부리는거야 대우 국가 돈 은행 돈 국민 돈 문어 발 식 확장 했고 IMF 는 김대중 이전 정권 만들어 낸 시 한 폭탄 이었다 그리고 기아 살리고 대우 죽였다 기아 현대차 넘어갔고 대우 뿔뿔 히 흩어져서 다른 회사 인수 되었는데 너 말 하는 죽 살리고의 기준 무엇 둘다 해체 돼서 다른 회사 넘어갔는데 누굴 죽 누굴 살렸다는 건지 이런 개 소리	FALSE
그럼 IMF 가 왜 왔는데 기껏 한보 하나 때문 왔어 기아 그룹 치명 타 먹였잖아 그 당시 기아 사태 기억 안나 지우고 싶어 기아 국가부도 주 범 이었지 그런데 주 범 왜 살려주고 그 피해 대우 그룹 덮어 썼어 그게 공정한거야	FALSE
IMF 도 김대중 작품 경제위기 신호 서 김영삼 정부 금융 규제 완화 조치 실시 할려고 법안 발의 정책 실시 할려고 국회 동의 구 했는데 경제 어려워야 정권 교체 유리하니 당시 야권 수장 김대중 기를 쓰고 반대 했지 IMF 구제 금융 없이 재정정책 해결 할 수 있었던 시점 놓치게 만든 원흉 핵대중 임	FALSE
살인자 대 중선생	FALSE
고인 명복 빕니다	TRUE
인간 김우중 깊이 넓이 어마어마하다 김우중 대구 경북 향 우회 머통 들 경제 재무 재정 공무원 들 친분 맺고 여기 특혜 지원 많이 받았지만 대학 운동권 들 좌파 들 일자리 기회 많이 준 사람 한국 불알 두 쪽 차고 사업 하려는 사람 들 김우중 꼭 벤치마킹 해야 한다 지금 벤 쳐 투자자 들 함께 사업 키울 수 있으므로 정경 유착 반면 교사 삼는다면 김우중 모든 것 철두철미 하게 벤치마킹 해도 된다 거대한 그릇 이었다	FALSE
세상 넓고 아직도 빨갱이 많다	FALSE
대 중이 북핵 바꾼 대우 그룹 ㅜㅜ 안타깝다	FALSE
분식회계 금감원 발표 검찰 발표 인대 북핵 대 중이 드립 나오냐 ㅉㅉ	FALSE
존경 하는 김우중 회장 님 명복 빕니다 살림 하는 주부 imf 를 전후 시절 대우 위상 몰락 함께 봤는데 믿기 어려운 뉴스 였죠 그 정권 경제 대변인 이 헌 ㅇ 님 잘 계신지 조문 했는지	TRUE
김우중 미래 경영 창시자 베트남 발전 아버지	TRUE
풍운아 존경 합니다	TRUE
얜 분식회계 등 추징 금 를 맞은 앤데 쳐 빨 들있네 ㅋㅋㅋㅋㅋ	FALSE
세계 넓고 사기 칠 일 많고 미납 추징 액 많겠지 ㅉㅉ	FALSE
제갈 대중 이희호 베게 송사 작품 대우 희생	FALSE
이름 광산 김 비슷한 돌림 김씨 주변 광산 김 애 들 많아서 저런 애기 쉽게 듣는게 김대중 대우 망하게 했다는건 족보 없는 민적 법전 노비 후손 들 생각 민주주의 볼수 없어 니 들 노비	FALSE
대한민국 경제 이끄신 대우 그룹 고 김우중 회장 님 영 연 하소 김대중 부관참시 하자	FALSE
무지하고 무식한 쓰레기 같은 댓글 들 보기 역겹다 우매 찌질 이 진상 들	FALSE
대우 그룹 입사 했던 선배 형 누나 들 다 쫓겨났지 좌파 운운하는 것 들 당시 경 제 환경 머리 생각 걸 하고 말 하는 건가	FALSE
삼가 고인 명복 빕니다 영 하십시오	TRUE
Imf 한국 방문 시 립튼 서머 스 그리고 머 중 이의 태세 전환 그리고 그 들 강요 인해 대우 해체 당함	FALSE
할 일 많고 세금 많다	FALSE
미안하지만 불법 대출 모은 돈 해외 뿌리고서 환수 못 해 없어진 엄청난 국고 낭비 대해 선 한마디 말 없이 떠나 버렸구나 추징 금도 한 푼 안내 어이없는 문어 발 식 경영 IMF 의 주 범 되어 수만 명의 임 직원 길거리 내 앉게 했던 일 추억 한 켠에 남아 있지도 않는 것	FALSE
지옥 김대중 보거든 뺨 후려 치세요	FALSE
미국 아무리 미국 천조 되는 돈 벌어다 준 회사 창업 주 들 빌게이츠 제프 베 조 스티브잡스 레리페 세르게이 브린 같은 사람 들 경제 일등 공신 경제 영웅 하진 않는데 솔 까 마이크로소프트 애플 아마존 구글 같은 회사 전세계 상대로 번돈 따지면 진짜 어마어마한 액수 그렇다고 미국 그런 회사 창업 주 들 영웅 생각 하지는 않음	FALSE
삼가고인의 명복 빕니다 좋은 곳 가셔서 편히 쉬십시오	TRUE
이제 편안히 쉬십시요	TRUE
우리나라 노비 이름 뿐 몰르고 참고 내 용자 이름 광산 김 아니지만 당시 저런 애기 많이 듣고 그리고 현실 적 세 손아래 기업 회장 근무 하면 나중 그 회사 해고 당 또한 그 아래 세손 뒤 담아까 서 그 업계 경력 살리지도 못 하는데 대우 현대 양대 축 경제 계 두 갈래 대우 쪽 하청 아는 기업인 들 프로 광산 김 우중 위세 손 근무 못 해 ㅡ 책임 잡으니 반대편 가서 다 사업 직장 생활 하니 결국 대우 쪽 아래애 들 맞고 반대편 김우중 위세 손 아는 경제 이렇게 된거	FALSE
김우중 김대중 무관 국민 깐거냐 일개 대통령 혼자 어떻게 까냐 광산 김 용자 이상 세손 돌림 쓴 아이 들 명이 깐거야	FALSE
또 한 명의 대한민국 경제 계 영웅 타의 의해서 망하고 세상 떠났네요 삼가 고인 명복 빕니다 영 면 하 소서	TRUE
김우중 회장 님 존경 합니다	TRUE
대우 로얄 엄청 우려 드셨지 각 그 렌 저 나올 적 너무 자만한것도 문제 였다 지엠 의존 안 했음 지금 대우 차가 그렇게 망하지 않았을것이다	FALSE
대우 무엇 들고 팔러 다녔나 생각 안나 묻는 것	FALSE
분식회계 잘잘못 뭐 이제 산 사람 들 몫 된거 위 서는 세계 경영 신명 나게 하시길 명복 빕니다	TRUE
좌파 정권 대우 해체 시켰잖아	FALSE
진짜 저 분 쉴드치는거 보고 딱 틀 딱 벌레 들 수준 먼 생각 사는지 파악 햇음 ㅋ	FALSE
고인 명복 빕니다	TRUE
삼가고인의 명복 빕니다	TRUE
편안하게 쉬세요	TRUE
고인 명복 빕니다	TRUE
분식회계 나라 IMF 사태 몰아 넣고 미납 세금 인데 무슨 영웅 게다가 아버지 박정희 스승 뒤 봐 준건 감안안하냐	FALSE
에잉 잡것 들 천하 상것 들	FALSE
청탁 안 들어 줘다고 ㅎㅎ 참 낮어이 없는 사람 ㅎㅎㅎ 틀 딱 들아 청탁 안 들어줘다고 욕 질하는것 들 머 도 대출 나간거 조사 해보자 ㅎㅎ	FALSE
권력 달콤함을 빨 먹는 기생충 들 너무 많다 이 정부	FALSE
그 놈 다 그 놈 유구무언 입니다	FALSE
목사 신부 정치 질 작작해라 직업 윤 리 개념 좀 장 착하고 신도 상대로 장 사질마라 사업 하니 광화문 제일 기쁜 때 개솔 하 십일조 삥 뜯는 개독 목사 것 모 기막혀	FALSE
문 정권 더럽고 추잡한 행태 보니 오히려 보수 깨끗해 보인다는 의견 진정 공감	TRUE
신혜선 님 이제 가톨릭 우파 돌아오게 힘써주세요	TRUE
문 정권 더럽고 추한 짓 보면 오히려 보수 정권 너무 깨끗해 보이	FALSE
그냥 봐도 대 깨문이구만	FALSE
이 분도 좌빨 들 이용 당하고 팽 당하셨네요 진실 밝혀지길 바랍니다	FALSE
거 긴 통째 빨 먹고 버리는 사회주의 조국 집단	FALSE
대선 하고 관련 있나 천주교도 나오고	TRUE
안보 안 믿는 조선일보	FALSE
알았 당 사이 언 슨 ㅋ	TRUE
기자회견 왜 열었을까 양 정철 꼼수 부리 마라 니 들 말 믿는 국민 없지 윤 검찰총장 님 철저히 수사 해 주십시요	FALSE
그니까 안 들어줬단 말임	FALSE
이 여자 좀 더 이상	FALSE
쩝쩝 이 요즘 잠도 안오겠네	FALSE
이런 추악 것 들 이나라 이끌니 추경 백조원 뒤 구멍 술술 새는구나 깜깜 백조원 추경 국민 들 정신차려야지 푼돈 몆 푼주다고 좋아하는 쓰레기 들보 한숨 목돈 좌파 들 주머니	FALSE
다 불자 아줌마	TRUE
헤선 천주교 신자답게 양심선언 해라 안 할것 같으면 주둥이 처 닫고 늙어서 죽던지	FALSE
양 정철 말 해야지	TRUE
윤석열 검찰 우리 들 병원 확실히 손 봐죠 왜 검찰 앞 윤석열 붙이는줄 알 윤석열 할수 있기 때문 윤석열 대한민국 살려줘	FALSE
박근혜 줄 섰으면 각종 특혜 주었을텐데 공명정대 정권 줄 서니 떡 하나 내려오지 않아 분노할만 하 군	FALSE
니 들 이용 할 때 언제 이 젠 선그 으 려고 양 정철 또 남탓 너 공명정대 정권 나라 다 말 먹어서 좋겠다	FALSE
스님 고 기 맛 보면 절간 파리 안남 아난다 운동권 시민운동 세력 권력 잡더니 물불 안 가리고 해 먹느라 바쁘다	FALSE
조국 사태 시작 추잡한 내막 하나 씩 드러나고 있는 건가 철저히 조사해 법 위반 사항 강력하게 처벌 해야 한다 나라 꼴 말이아니다	FALSE
너 자유당 갈려고	FALSE
살다 살다 이렇게 조잡한 정권 첨 본다	FALSE
세상 공짜 어디 있냐	FALSE
천주교 이용 당했는지 정의 외치는 신부 하고 같은 생각 문씨 쫄개 들 신씨 은행 측 붙어서 돈 챙기고 돈 행방 추적 하면 답 나오겠네 지저분하고 더러운 민주당	FALSE
신혜선 너 운 재앙 대통 만드는데 한몫 했네 다만 특혜 이상호 밀린거고 이건 친문 들 특혜 비리 싸움 대한민국 잘 돌아간다 국정 농단 어쩌구 하면서 보수 정권 몰락 시켰지만 좌빨 종북 정권 대한민국 통째 말어 먹으려 던벼 다 이 좌빨 종북 정권 수괴 지지율 나 된다니 여론조작 기관 폐쇄 하기전엔 정상화 되지 않을테고 이래저래 국민 서럽구나	FALSE
시래기 정권 탄핵 가자	FALSE
문재인 괘 심하면 이 여자 우리나라 최고 권력자 윤석렬 잘 어울리겠다 괘 심해서 문재인 규탄 하는 여자 뭐 걱정	FALSE
실제 상황 입니다 퇴임후 정치 적 보험 공수 처가 좌절 된 경우 북조선 야 반 도주 가능성 배제 못 함	FALSE
문재인 괘씸한 인간 당신 어제 저녁 티비조선 뉴스 보고 얼마나 통쾌하게 저녁 먹었든지 늦게나마 달창 탈출 하신것 진심 감사 드립니다	FALSE
검찰 신속히 철저한 재 수사	TRUE
그런데 참 재미있는게 기레기 조선 갈겨쓴 기사 들 딱 알바 들 보수 아닌 것 보수 가장 토착 왜구 친일파 친미파 등 권력 바퀴벌레 충 들 잔뜩 달라붙어 댓글 질 있단 말 애 들 바퀴벌레 약 좀 쳐라 그 래야 지 들 끼리 약 먹은 바뀌 벌레 나눠 먹고 또 먹고 하다가 자멸 하는거지	FALSE
좌빨 대 깨문은 부들 거리 그냥 아닥 하고있어라 ㅋㅋ	FALSE
대가리 깨졌으면 병원 가세 여기 이러지말고	FALSE
뇌 궁금한 인간 ㅠ	FALSE
병원 갈 넘 들은 모두 니 넘 들이야 내 댓글 중 틀린거 있으면 댓글 달 봐	FALSE
까도 까도 문재인	FALSE
대 출금 어디 쓰여졌는지가 핵심	FALSE
도저히 이해 안된다 자발 적 포기 각서 쓴 걸 가지 왜 이제 와서 문제 삼는지 억지 생떼 부리기 아냐 그걸 기레기 조 센이 받아 까는거 구마 역쉬 토착 왜구 친일파 친미파 권력 바뀌 벌레 들 기관지 대변 지인 조선 반드시 폐간 되어야 한다	FALSE
이런 더러 번 새끼 들	FALSE
진정한 국정 농단 문 일당 하고 있네 시바	FALSE
문 패거리 들 하나같이 쓰레기 들	FALSE
우리들병원 얼마나 큰 대기업 이길래 산업 은행 대출 해 줄까 뻔하네 문 정권 산업 은행 장 임명 마음대로 하니까 당연히 대출 이번 조국 안 끼어들었을까 나	FALSE
국민 들 우리 들 병원 원래 망햇었는데 정권 잡으면서 대출 완전 살아난 거 이상호 원장 원래 망해서 해외 도피 그 랫었 는데 대통령 밀어 준거로 살아난건데 저런 짓 한 거 뻔하지	FALSE
문 패거리 들 하나같이 쓰레기 들	FALSE
재인 서울구치소 자리 비워 놨다 빨리 들어와	FALSE
이명박 대강 는 눈알 희 번뜩대며 짖어 대고 절름발 펭귄 북한 퍼준 그리고 귀걸이 애비 청년 일자리 만든다고 쓴건 아닥하 전라도 홍어 들	FALSE
문재인 죽은 노무현 못 당하는군 노무현 대모 김수경 문재인 대모 신혜선 아니던가	FALSE
역시 문재인 그 일당 들 비리 여기저기 솟구치는군 좌빨 들 또 개 소리 불어 대겠군	FALSE
그러니까 좌파 지지 하면 통수 맞는게 당연하다 이 말	FALSE
죄인 이 범죄 안 끼는데가 없다 얼굴 봐라 악마 살인자 상이	FALSE
관상 좀 보시 분 ㅋ	TRUE
기 사 제목 보고 수꼴 틀 딱 개됗 들만 처 본다는 극 우일 간 좇선 일보 예상 했다 늼김	FALSE
미친 개 주작 인간 이군	FALSE
알면서도 모르는 체 하는 현 정권 실세 들 이런 인간 들 믿고 살아가야 하는 국민 들 불쌍타	FALSE
저런 일상 적 이었으니 조국 네 대출 떼 먹는건 그냥 당연한거였겠지 적폐 청산 기다려라 역사 도도한 정반합 그 흐름 제대로 적폐 청산 될 날 멀지 않았다	TRUE
광화문 니 들 꼼수 낱낱이 밝히리라	FALSE
양 정철 문 재앙 헬 게이트 열리나요 문 재앙 지은 죄 너무 많아 한 열 번 정도 사형 언도 받을것 같다	FALSE
제 의장 영자	TRUE
요 설 혹세 무민 지금 국민 들 개 돼지 아님을 명 심하라 왜곡 가짜 뉴스 공작 허위 선동 열심히 한 다만 ㅊ ㅊ	FALSE
문재인 엮이 저렇게 됩니다 피 눈물 없는 빨갱이 들 오직 자신 들 이득 미친 악마 사탄 들입니다	FALSE
윤 총장 님 이 거제 수사 해 주세요 이제 대한민국 믿을건 윤 총장 님 검찰 없습니다 이러다 우리나라 베네수엘라 망국 길 가는거 아닌지 걱정 돼 잠 안옵니다 공 수 처 반드시 막아야 합니다 문재인 탄핵 우리나라 살릴 길이	FALSE
머리털 하나 범법 자 만들어 적폐 청산 미명 하 감옥 보내더니 지 들은 블루 하우스 온갖 비리 조종 했구먼 이 것 들 바로 적폐 대상	FALSE
정신병 자	FALSE
문죄인 시궁창 냄세 진동 하는 정권 있긴 했냐 사람 들 가지는 인정 한다 능력 있는데 조금 해먹 던지 무능한데 엄청 깨끗하던지 근데 현 정권 무능한데 역대 급 해먹 지저분해 내 예 언 하나 할께 법정 가면 문죄인 최소 형 받는다	FALSE
권력 도전 하는것은 진짜 억울해서 목숨 걸고 모든 것 걸고 하는것 아닐까	FALSE
ㅂㅅ 우리 들 은행 실질 적 대출도 안되는 곳 이었는데 대출 해줬단다 문죄인 당선 되고	FALSE
사업 상 금융 대출 문제 의혹 있다면 고소 고발 해서 법적 해결 하면 될 일 대통령 친분 있다고 대통령 나서서 해결 해야 되는가 대통령 그렇게 한가 한가	FALSE
신혜선 이 안꼬없는 찐빵 망언 했다	FALSE
문 빠 들 댓글 진짜 이제 개토 나온다 직접 눈 좀 보고싶네 어떤 사람 들	FALSE
멀쩡한데 골 비었슈 ㅋ	FALSE
저 놈밑 생긴것부터가 엦날 간 신들 같아 똑같아 신기하네	FALSE
특히 야 정철 더러운 놈	FALSE
좌파 들 바쁘네 댓글달아 여론 조작 다 고 막아도 막아도 계속 나오네	FALSE
당신 괘씸하네 순수하게 선거 원한 아니라 전 물린 대출 해결 노린듯	FALSE
대선 때 총선 때 선거운동 하는 인간 들 대부분 ) 이 저런 인간 들 뿐 나머지 가 노사모 같은 정말 순수한 지지자 들	FALSE
이 여자도 참 이상한 사람 개인 일 왜 대통령 해결 해달라고 청탁 하시죠 문 대통령 그렇게 개인 일 국가 권력 해결 할 거 생각 하셨는지 나쁜 사람	FALSE
미래 가치 대출 나도 미래 벌수 있으니까 나 대출 해주라	FALSE
때 문 통 무슨 힘 있었다고 이런 주장 하는지 이해 안 간다 억울한게 있으면 법원 소송 걸어서 법 결과 기다려야지 이런 언론 플레이 뭐 해결 되겠나	FALSE
아무리 자유 라지 자신 쓴 글 예의 가지세요	FALSE
좃선 일보	FALSE
결국 문 대통령 사사로운 이권 개입 전혀 안 하셨다는거네 역시 그런 건 이 멍 닭그네 부탁 하셨어야죠 ㅋㅋㅋ	FALSE
천주교 오우 실망 요	FALSE
그 딸 경제 망친게 문재인 ㅋ	FALSE
야비한 인간 문재인 줄 선 당신 어리석은 거지	FALSE
양심 가지 살자 양 정철 문재인 것 들 같이 다니다가 자기 불이익 생기니 욕 하는가 강도 살이 범 욕 하면 강도 아닌가 지금 사악한 시대 내 살 있다니 참으로 역겹다	FALSE
문재인 주변 온통 악취 진동 하는구나 쓰레기 한가득	FALSE
그러게 왜 문재인 도 왔냐 뿌린대로 거두리라	FALSE
은행 과연 당시 집권 하던 엠비무시 문재인 위해 그랬겠냐 ㅋㅋㅋ 산업 은행 더군다나 강만수 회장 이었는데 ㅋㅋㅋㅋ	FALSE
사건 문죄인 당선 바로 전이	FALSE
최 순 실과 박근혜 조 족 지혈 유권 무죄 무 권 유죄	FALSE
계속 해서 그리 살아라	TRUE
문죄인 모조리 구 속 수 사하라	FALSE
마저 년 국회의원선거 폭 망후 바로 탄핵 ㅎ ㅎ	FALSE
태생 그것 안 되는 자 들 새삼 뭘	FALSE
요 놈 들 냄새 펄펄 나 그만	FALSE
더불어 강간 하 샛기 들 비리 천국	FALSE
ㅋㅋㅋ 청탁 시도 셀프 인증 하 ㅋㅋㅋ	FALSE
전 생각 했던 거지 양 정철 조국 털면 문 재앙 죽 때 깜빵 생활 할거다 ㅋㅋ 박 그네 국정 농단 때렸지 정권 바뀌어라 이 새 기 들 이런 불법 뒤 다 저질러놓고 지 들은 깨끗한 척 적폐 청산 해 ㅋㅋㅋㅋㅋ	FALSE
전 부인 그럼 이혼 나서 기자회견 하는거 임	FALSE
조 땡 일보 기레기 들 이번 우리들병원 꽂혔네 윤석열 뻥 쟁이 와 자 한 당 동 일체 떡검 조작 질 과 겁박 수사 취재 좀 해 조 땡 일보 기레기 들 떡검 전용 나팔수 지금 개월 남은 총선 떡검 선거 개입 수사 있는거 같은데 그리고 기레기 들 대글빡 손목 아지 주둥이 사주 꺼 데스크 전달 사항 존나 받아쓰기 하는 진실 보도 엿 바 꿔 먹지 엿 장수 맘대로 기 사내 아님 말 구식 기사	FALSE
우리들병원 철저히 수사 하세요	TRUE
하여간 좌파 들 뒤 온갖 비리 삶 살면서 깨끗한 척 오지 한다	FALSE
니 들 좋아하는 그 잘난 검찰 고발 해 그러면 해결 해주겠지	FALSE
불법 집단 사기 청와대 문죄인 정부	FALSE
문재인 괘씸한 새끼	FALSE
우리들병원 불법 대출 받아 선거 자금 쓴 것 분명합니다 문재인 정권 지 들이 적폐 였네요 양 정철 국정 농단 수사 해야 합니다 최 순 실 애교 수준 입니다	FALSE
양 아치 년 주장 좃선 또 받아 적네	FALSE
공 수 처 설치는 절대 하면 안 되겠지요 권력자 들 공 수 처 이용 해 검찰 협박 해서 권력자 들 범죄 수사 영원히 못 하게 만들게 됨 공 수 처 권력 개 권력 개 슈타포임 공 수 처 절대 안됨 특히 중요 피 같은 국민 세금 밥 먹고 살아가는 공무원 정당 정치권 등레 공소 시효 없애야 됨	FALSE
반드시 지옥 가길 바랍니다	FALSE
아까운 애국자 한 분 타개 하 엿 구나 죄인 그 일당 또 라이 들 와이 리 맹 기노 도살 할자 누구 랴	FALSE
cho 저 질 동무 양 아치 짐승 광명 빛 보는것이 아깝구나 암흑 세 개 인도 하리 내 너 타개 해줄께 도살 말 깐나셐키	FALSE
cho 저 질 동무 이 탈북 하 레비 시 비걸 엇음 메 북 개 특수 군 출신 나가 반 다시 저 질 짐승 도살 하러 갈거 임메 필시 도축 하 갓	FALSE
저 질시 런 발 게이 도망 갓 어 오 라우 동무 반 다시 도축 하 갓 어	FALSE
소박하지는 않은것 같습니다	FALSE
한 명의 개신교 목사 개 이상 아이디 댓글 조작 하 인터넷 댓글 조작 천국 한국	FALSE
괴뢰 좌익 뒷 통수 홍어 색기 들 전설 쓰레 기 색기	FALSE
전라도 공부 잘 하면 차별 없이 사시 패쓰 하고 삼성 법무 팀 뽑아주고 단물 다 빨 먹고 통 수지대로 쳐서 역시 전라도 뽑아서 쓰면 안된다는 선입견 만든 쓰 렉 지는 단물 빨 정의 상징 인양 또 단물 빨았겠지만 정의구현사제단 최악 질 전교 소굴 광주 교육청 얼척 없다 그냥 광주 태어나서 광주 학교 다니는 애 들 뭔 죄 너 같은 놈 밑 빨갱이 좌빨 교육 받은 아이 찍힐 뿐 광주 애 들 스카이 간 들 삼성 같은데서 뽑아나 주겠냐 너 같은 놈 땜 전남대 생 들 기업 죄다 빨갱이 취급 안 뽑겠지	FALSE
배신자 단물 다 먹고 버리는 절대 기업 뽑지 말아야하는 인간 형 일제시대 였으면 친일파 전형 적 기회 주의 인간 형	FALSE
이 사건 이후 호남 사람 들 삼 성 그룹 임원 달기 더럽게 어려워졌다고 하는데 사실	FALSE
삼성 정치인 줄 뇌물 조성	FALSE
김용철 나서면 황교안 끝	FALSE
삼가 고인 명복 빕니다 박통 때 부름 받아 바로 한국 줌 공업 옥포 조선 등등 다양한 부도 기업 개 살리기 부채 않고 살리기 세계 위국 못 하는 소련 수출 유럽 북쪽 산 골짜기 헤리 곱타 산꼭대기 수출 빚 갚기 하다가 견 대중 주 대우 계열 개 대기업 협력 업체 개 공중 분해 오늘 명 실업자 천국 배고파 극단 적 가족 몰살 세계 위국 만든 넘 들 그 모자라 북한 수백 조원 퍼줘 오늘 핵 미사일 공포 몰아 넣은 넘 일을하면 우울증 치매 환자 없다고 해놓고선 전국 고통 받는 치매 가족 일본 배 늘어 죽지못해 사	TRUE
실력 없이 말로 세계 경영 결과 추징 금은 내야	FALSE
그 와중 기자 이건희	TRUE
삼가 고인 명복 빕니다	TRUE
삼가 고인 명복 빕니다	TRUE
김우중 처럼 경영 하면 안 된다 김우중 제품 관심 없고 규모 집착 한 거 또 다시 경영 해도 저 꼴 날거다	FALSE
삼가 고인 명복 빕니다	TRUE
아깝다 더불어 호남 공산당 사실 상의 시조 김대중 때문 더 큰 꿈 펴지 못 귀 천하였으니 그래도 진심 김우중 회장 존경 하는 사람 들 많 음 위안 받으시길 김영삼 김대중 같은 사이비 정치 꾼 들보 훨씬 편안하게 명복 받으 시리 봅니다	TRUE
범죄자 디	FALSE
열심히 사신것은 인정 해 드려 야합니다	TRUE
이분 ㅇ 우리 아부지 주식 휴지 조각 만 드셧 는데	FALSE
죽으면 다 영웅 되네 분식회계 추징 금 가 넘는다	FALSE
세계 누비 되 세금 내고 가시오	FALSE
개인 적 생각 뚝심 강한오 너 덕분 기술 개발 새로운 도전 그리고 일자 리창 출 고인 되 신분 숨겨 둔 재산 없는데 그동안 많은 국민 들 먹여 살려다고 생각 합니다 조용히 보내 드리는게	FALSE
세기 장보고 이만 도전 정신 있는 인물 또 나타날지 젊은이 꿈 가져라 세상 넓고 할 일 많 타 정말 멋있짢 평안히 영 하세요	FALSE
대우조선 다니던 때 대우 그룹 어떤 회사 였는지 관심 생겨서 김우중 회장 님 어떤 분 책 들 찾아 읽어 보며 알 됐습니다 거제 아직도 세계 넓고 할 일 많다 출 간 기념 회 때 딱 한 번 뵐 수 있었습니다 명의 추모 객 조 문 인사 들 고인 어떤 분 충분히 증명 됐다고 봅니다 고인 업적 위대하지만 회장 님 보여주신 모든 행동 들 사람 들 오랜 기간 감동 했고 잊지 않을 것 생각 합니다 김우중 회장 님 산업화 세대 가장 큰 거인 영웅 입니다 고인 명복 빕니다	FALSE
지옥 죄값 톡톡히 받으시길 하나님 이름 축원 하는 바 입니다 명복 개뿔	FALSE
문씨 도 붙이 싶은 제목	FALSE
은 국민 세금 해결 해야 합니다	TRUE
기자 이름 이건희	TRUE
국민 피 빨 아목 사기꾼	FALSE
추징 금은 내고 가야	FALSE
죽어야만 쉴수 있는 사회	FALSE
사기꾼 쉨	FALSE
세계 적 분식회계 사 기범이 존경 받는 희안한 나라	FALSE
그동안 이나라 나셔서 어려운 해외 시장 개척 노고 감사 드리며 삼가 고인 명복 빕니다 이제 모든 것 잊고 편히 잠드소 당신 개척 정신과 근면 성은 잊지 않겠습니다	TRUE
명복 빕니다	TRUE
존경 하는 회장 님 영 하십시요 점심시간 구내식당 마주치던 흰 와이셔츠 노 타이 차림 소탈 검소 하시던 당신 모습 떠오릅니다	TRUE
건강하신줄 알았는데 맘 아픕니다 그동안 고생 많이 하셨습니다 편히 쉬세요	TRUE
ㅋㅋㅋ 분식회계 꾼 아마 미국 이었으면 깜빵 죽었을것인데 대우 땜 피 흘린 사림 들 생각 않고 dj 타령 하고있네 ㅉ	FALSE
진심 존경 하는 분 떠나셨다 명복 빌며 편히 쉬 시기 바랍니다	TRUE
잘 살 잘 가면 된거 행적 업적 논 하는게 아니라 죽으면 다 끝 거 기억 뭐 크게 의미 없다 본인 인생 각자 사는 거	FALSE
그때 국민학교 학년 이었고 광주시 학동 살았다 나도 헬리콥터 소리 사격 소리 다 들었다 총탄 창문 뚫고 들어올까봐 솜 이불 커텐 가리고 잤다 어떻게 몇 백만 명 같이 들었다고 증언 하는데도 대부분 다 생존 해 있는데도 이 걸 왜 계속 증언 해야하지 당연한 역사 적 사실 인간 말종 전두환 같은건 누가 벌 주	FALSE
진짜 헐이다 이런 기사 김일성 얘기 왜 나오는거죠 분명한 사실 그 일 겪고 가족 슬퍼하는 사람 이렇게나 많은데 이 빨갱이 소리 들어야 할 이야긴 가요 세월호 그렇고 광주 민주화 그렇고 왜 다 들 논리 없이 빨갱이 모 건지 한심하네	FALSE
인정 머리 하나 없는 사람 들입니다 이분 들 돌아가시면 아베 똑같은 괴물 될 수도 있을 겁니다 터럭 양심 가책 이제 느끼고 역사 앞 참회 하시길 빕니다	FALSE
광주 폭동 세월호 은 우려 먹을거다 북한 중국군 총 쏘고 국민 들 죽인건 가만히 있고	FALSE
전 두 화 씨 문산 당 씨 중 전 두 화 씨 정권 그래도 살 했다고 생각 되면 공감 지금 문산 당 정권 살 만하 생각 되면 비 공감	FALSE
어휴 일베	FALSE
논리 없고 ㅉㅉ 여기 갑자기 현 정권 왜 나오 ㄴㅑ	FALSE
지 부모 형제 두 환 이 살점 뜯겨 죽어도 정신 못 차릴 일베충 새 퀴 들	FALSE
ㅁㅊㄸ 라이 들	FALSE
문산 당 무 찌르자	FALSE
헬기 사격 있었다는 명백한 증거 보여라 들었다더라 내지 카더라 좌빨 이야기 믿을 수가 없어서 말 워낙 거짓말 생활화 되어있어서	FALSE
나 공산당 싫어요 천주교 싫어요	FALSE
진실 뭔 지 알수가 있어야지 죄꾹 보고 나서는 영 믿음 없어졌어	FALSE
전두환 비호 세력 지난번 광화문 모이셨죠 그리고 이분 들 늘 우리 이 먹고사는것은 다 박정희 전두환 덕분 말씀 하시더군요	FALSE
사실 너희 모시는 김일성 혹은 김정일 우리 나라 잘 살 해주 않았잖아 ㅋㅋ	FALSE
이 시점 조국 물 타기 하려고 드런 세상	FALSE
전씨 편히 뒈지 기전 꼭 밝혀서 죄값 받고 전 재산 몰수 시키자	FALSE
으 따 전장군 님 그때 헬기 아니라 원자폭탄 하나 쐈어야 했는데	FALSE
고마 해라	FALSE
그 짝 사람 들 못 믿는 당 ㅋㅋ	FALSE
평신도 믿지 못 하겠다	FALSE
헬기 사격 목격 했고 안 했고는 왜 따져 ᆢ 현장 총탄 흔적 아직도 남아있는데 ᆢ 명백한 증거	FALSE
전두환 사형 마땅하다	FALSE
거 짖말 좀 ㅉㅉ	FALSE
어떡 하든 꼭 심판 해주세요	FALSE
국민 향 해 사격 했던 잔당 들 아직도 현재 기만 갑질	FALSE
거짓 진실 이길수 없다	TRUE
했다하고 미안하다 하지	FALSE
전장군 진짜 장군 감	TRUE
이제 서 증언 ㅎ 천주교 신자 어이없네	FALSE
나도 천주교 맹신 하는 맹신 자 입니다 나도 봤는데 뭘 어떻게 보셨는지 구체 적 신빙 성 있게 진술 해보시지요 누가 그래 부렀네 하 땀시 자네 봐 쁘렀 다 고안 했 능가 그러지 들 마시고 보신것만 들으신 것 유언비어 일 뿐입니다	FALSE
소리 들었다는 증언 헬기 사격 받았다고 한 사람 들 선동 하지마라 헬기 조종사 들 기 총 소사 없었다고 다 밝혔는데 역시 선동 하네 이러니 은 재 조사 되어야하고 유공 자 공적 조서 공개 해야 한다	FALSE
이제 좀 덮자 망각 때로는 이로을 수 있다는걸 알자 우리 내일 있는데 왜 과거 매달리는지 참 답답하다	FALSE
민간 이 경찰 먼저 죽엇다 면서	FALSE
그래 이쯤 한번 나와줘야지 다음 세월호 준비 됐냐 준비 됐으면 쏘세요	FALSE
아랐다 그래서 머	TRUE
거짓말쟁이 전두환 자서전 자칭 찬양 지가 쪽 빠리 줄아나 봐 역사 거짓 꾸미네 전씨 보면 자 한당 과거 였나 생각 이드	FALSE
뭔 놈 재판 하면 무엇 하냐 그냥 사형 시켜라	FALSE
정조 시대 천주교 지금 천주교 다르잖아 그 때 자생 적 이었고 성경 적 라면 지금 외래 적 미신 적 그 때 우상 숭배 배격 해서 탄압 받았다면 지금 우상숭배 장려 하던데	FALSE
증명 할수 없으니 지르고 보네	FALSE
독실한 천주교 신자였던 윤지충 정약종 성경 금 조상 제사 거부 하다 순교 하셨는데 현재 천주교 제사 허용 한다 그 당시 교황 제사 금지 했지만 그 후의 교황 제사 허용 했기 때문 예수님 너희 어찌하여 너희 전통 하나님 계명 범 하느냐 고 하셨다 천주교 성경 말씀 사람 말 따르는 종교 각 시대 교황 각각 무오 한 데 그 두 교황 만든 중요 법 상충 할 수 있나 성경 진리 변하지 않는다 변한다면 진리 아닌 것 천주교 제사 허용 순교자 들 두 번 죽이는 것	TRUE
인천 성모 병원 감사 드립니다 전달 해주신 성금 북한 어린이 들 한 줄기 빛 될것이고 아주아주 큰 도움 될것 입니다 저희 하지 못 하는 일 대신 해주셔서 감사합니다 앞 인천 성모 병원 응원 합니다	TRUE
산고 고통 힘든 작업 이었을건데 애쓰셨네요 좋은 작품 잘 보았습니다	TRUE
김대중 대통령 최대 실책 저 살인마 넘 들을 사면 해줬단 거	FALSE
칠 푼 쥐 박이도 그렇고 저런 쓰뤡이들 절대 자살 안 한다 베충 들이 좋아하는 것 들 다 욕 쳐 먹고 잘사는 것 들	FALSE
저런 쥐 OOO 같은 ㄴ 이아 직 살아있다니 하늘 천벌 내려 저 것 들	FALSE
전두환 살인마 광주 산 사람 수천 죽 이 젠 그 모자라 죽은 사람 또 한번 죽이는 살인 전두환 니 죽기전에 반성 사과 한마디 하 니 일본 아베 다르잖아	FALSE
곱 뒤지지마라 뒤져서도 영원히 욕먹어라 역사 무섭지 않냐	FALSE
이번 기회 전두환 고 유정 이춘 재등 합동 처결 해야 합니다 정말 인간 쓰레기 들 좀 치워주세요	FALSE
자 한당 원하는대로 사회 반 쪼개졌다 자 한당 년놈 들 선동 질 여기 우리 물러설수 없다 수많은 세월 동안 온갖 고문 몽둥이 군홧발 총 헬기 살인 앞 민주주의 위해 고통 싸워 피 흘리고 희생 하며 목숨 바쳤는데 이렇게 허 멍하게 물러설 순 없다 지 금세 상 범죄 조직 자 한당 이 들 얽킨 부패 세력 들 친일파 들 군부독재 세력 국정 농단 사법 농단 부정부패 세력 대갈 통 빨갱이 무장 꼴통 들 이 들 영혼 뺏긴 똥 오줌 못 가리는 멍청한 인간 들 데리 다시 과거 회귀 하려 한다 막아내 야한다 또다시 제 의 명박 이 닭년 만들수 없다	FALSE
예전 풀어주지말구 판결 바로 사형 시 켯 어 야한다	FALSE
전두환 최대 실책 깽깽 이 두목 죽 못 한것이다	FALSE
문 통 최대 실책 이런 쓰 뤡 베충 들도 민주 주위 누릴 수 있게 해준것이다	FALSE
노통때 널 어찌 해야 했어야 하는데 아깝	FALSE
얼마 안 남았군	TRUE
전두환 잘 한건 통금 시간 하며 조폭 양 아치 들 잡고 민주화 운동 세력 조진건 잘 했다 지금 시끄러울 때 전두환 같은 분 자 한당 민주당 다 작살 내고 통금 시간 만들어 야간 못 돌아 다니게 하고 유흥업소 성매매 성 매수 관계자 싹 다 잡아 삼청교육대 보내야 함	TRUE
자연사 원하지 않는다 저 살인마 사형 시켜라	FALSE
마지막 가시는 길 콩밥 좀 드시고 가도록 해드려라	FALSE
두 환 이 사형 안 시키냐 무능한 좌파 정권 ㅉㅉㅉ 민주주의 개나주시구 쥐 닭 사형 시켜라 나라 시끄러워서 못 살겟다 LPG 유조 트럭 탈취 싶다	FALSE
두 환 책 냈더라 밀린 세금 추징 해라	FALSE
개두 환 얼 넘아 인제 좀 땅속 들어가서 썩어라 질긴 새 키 ㅋㅋㅋ	FALSE
군부독재 시대 조작 질 정권 살인 부대 살인마 전두환 쓰레기	FALSE
등장 핵심 증인 그동안 뭐 하셨수 기억 력 좋으신 가봐 수십만 명 중 왜 당신 핵심 증인 또 증거 조작	FALSE
절 법정 뭐 가능함	TRUE
그 동 은 정권 말 하면 들어나 줬냐 쥐 닭 새 키 언론 말 못 하던 언론사 새 키 들	FALSE
아직도 두 환 같은 독 째 빨 갱 역쩍 반역 짜 매국노 앞 짭이 등 찬양 하는 버 어러지 들 틀 딱 충 기생충 꼰대충버어러 가짜 보수 악 찔 쓰레기 언론 들 문 통 찐하게 뜨겁게 뼈 저리 독 째 맛 보여줘야 쏠 까말 문 통 사람 진짜 좋으니까 못뙨 요것 들 숨쉬고 있는줄 알아랏 버 어러지 들	FALSE
홍어 썩은 구더기 쉐 ㅣ 끼 한심한 좌빨 쉐 ㅣㅣ 끼	FALSE
망국 뼝 지역감정 종북 팔이 부추기고 이 간질 하 빨 갱 역쩍 반역 짜 노예 종놈 중쯩 환자 버어러지쒜끼 니 넘의 처자 식 자손 대 쪽 빠리 성 노리개 되고 노예 종놈 된다	FALSE
세월호 자꾸 진상 조사 하자는데 그 들 주장 하는 진상 이 도체 무엇 입 ㆍㆍ 세월호 누가 폭파 시 겼나요 자연재해 아닌가요	FALSE
자연재해 뜻 모르나 봐 ㅋ	FALSE
그러길래 동물원 사자 왜 건드렸냐 사자 명예훼손 당하게	FALSE
친일파 청산 못 해 일본 저러는 것 전두환 군사 쿠데타 광주 학살 원흉 전두환 반드시 역사 적 엄벌 처 해야 한다 그 래야 대한민국 역사 바로 선다	FALSE
사자 만든거는 언제 묻냐	TRUE
진보 하는 선 공짜 퍼주는 선 ㅋㅋㅋㅋ 하늘 비웃어요 거 져 쳐 먹으려는 악행 이 정의	FALSE
망둥이 뛰니	TRUE
대단한 전두환 검찰 뭐 하는거여	TRUE
얼른 깜빵 보내자 곧 겨울	FALSE
쟤 아직도 살아있네	FALSE
손석희 폭로 미국 방정 보국 문서 Kwangju riots 로 표기 하는 게 공정하다	FALSE
저런 인간 어떻게 핵심 증인 살 소 대가리 앙 천 대소 하겠네	FALSE
아직 안 죽었냐 이런 살인마 아직도 대한민국 당당하게 얼굴 내비 살아간다는게 한 이 맺힌다 독재 문제 아니다 아웃소싱 업체 일감 몰아주기 육사 모임 등등 편 가르 기를 당연한 문화 만든 장본인 아니냐	FALSE
고령 심신 미약 아닌가	FALSE
전 대갈 감옥 죽는게 바람직하다 수많은 사람 죽여놓고도 잘 먹고 잘사는 넘	FALSE
이 쌔끼 들 간땡 가부 엇냐 정인 미사일 한 방만 부탁 다 도교	FALSE
전 대통령 전두환 당신 피 할 수 없는 것 보이네요 생전 못 받은 벌 조만간 받겠네요 어마 무시 하	FALSE
그래도 죄인 낫	FALSE
자망 당 죄 짓고도 발뺌 하 거나 덮어 희 우기 유전자 신부 덮어 씌우고 여상규 판사 시절 간첩 조작 판결 하고 지금 법사 위원장 하며 자기 죄 수사 하지 말라 한다 그리곤 검찰 개혁 반발 현 정부 수사 외압 불공정 하다며 덮어 씌운다	FALSE
전두환 김재규 심문 해서 박정희 시해 사건 내막 아는 사람 그것 딜 을해 대통령 된 사람 누가 전두환 건드려나라 뒤집어진다	FALSE
당시 헌혈 막았던 문서 나왔는데 전두환 살아있을 때 반드시 처벌 받아 야한다	FALSE
빨리 빨리 차별금지법 입법 해서 ㅡ 광주 오욕 하 섹휘들 다 살 처분 하자 ㅡ 한국 당 골수 빠는 부산 광주 능멸 없는데 ㅡ 죄다 대구 넘 들이냐 ㅡ 야 튼 동 서 내 전이 맞다니까	FALSE
광주 시민 폭도 몰고 잔인무도하게 학살 하여 사형선고 받았던 전두환 생명 은인 바로 노벨평화상 받기 위해 전두환 풀어 준 전직 대통령 김대중 임 우리 기억 합니다	TRUE
전두환 대통령 님 조금 버티세요 검찰 공 수 처 사법 개혁 한 뒤 풀려나실 겁니다 전두환 뭐 잘 못 했는데 지 들은 뇌물 안 쳐 먹었냐 그리고 광주 사태 나오지 말 개엄령 내려서 거리 다니는 사람 잡는다고 미리 통보 했다 지 들이 나와서 뒤진거 가지 억울해 ㅁ ㅊ	TRUE
문재인 보다 만배 훌륭했다	TRUE
지 금은 전 두 환 조국 먼저 수 사하라 과거 돌지말고	FALSE
전두환 돈 챙긴건 범죄 공산당 학살 한 건 잘 한거다 공과 사는 분명히 하자 ㅋㅋㅋㅋㅋ	TRUE
참 김대중 노무현 때 뭐 있다가 이 제사 기어 나오냐 니 들 어지간히 해	FALSE
또 광주 병 들고나오네 더불당 이 많이 후 덜덜 하 보네 명단 공적 사항 공개 해서 가짜 들 가려내고 진짜 유 공자 들 싸잡아서 욕먹게 하지말고 그 분들 명예 되찿아주 진정한 마음 우러나 예우 제대로 하자	FALSE
그래서 어쩌라고 전두환 이 헬기 타고 사격 했냐 조국 기만 나 놔고 재판 끝난 전두환 얘기 그만해라 언제 과거 집착 미래 갈 능력 안 돼지	FALSE
헬기 사격 애 들 장난 줄 아 사격 햇 다 면 숨길 수도 없을 뿐 아니라 목격자 수 천명 되 긋다	FALSE
고만 좀해	FALSE
멀 고만해 이 게 잊혀져야 됄 사건 이 니 그 자리 있 엇 봐어 케 돼나	FALSE
관심 없어	FALSE
헬기 어떻게 사격 하는지는 아시나요 헬기 바닥 하늘 쏘는 지 대공포 아시	FALSE
군대 가서 m 소리 못 들어 봤나 보네 소리 물론 공기 흔들릴 정도 그걸 듣을 사람 두 어명 뿐 ㅋㅋ 다른사람 들 전부 귀머거리 그리고 탄흔 적 m 확인 됬는데는 무슨 개 소리	FALSE
본거보다 증거 내놔야지 썰 로만 몇 십년 전의 일 증명 한다면 말마 추기 살인 가능한거 아닌가	FALSE
전두환 이 이렇게 미워하진 않았다 하지만 지금 문재인 미치도록 싫다 저 대통령	FALSE
헬기 사격 뒤진 놈 다친 놈 유공 자 나와 봐야지	FALSE
저 폭도 들 헬기 선빵 날리는 거 봄	FALSE
그만 해 마이 무 따 아니가	FALSE
헬기 사격 해놓고도 거짓말 하네 일본 놈 들 보는 것 같다	FALSE
조 ㄱ ㄲ ㅏ 사기꾼 색기	FALSE
댓글다는 쓰레기 들 역시 꼴 통보 수 쓰레기 들답다 쓰레기 아니라고 우기는 놈 들 친일 쪽바리 아니면 일베충	FALSE
왜구 교활한 왕교 활 아베 족속 들 느네 안되는 거야	FALSE
사람 증언 참고 사항 되겠지만 전적 의존 하면 안된다 지금 역사왜곡 가져온 거의 대부분 경우 사람 증언 지나치게 믿은 결과 였다 가장 비근 예 한 일본인 제주도 성산포 수십 명의 부녀자 들 강제 납치 해서 군 위안부 넘겼다고 한 증언 아사히신문 보도 돼 난리 났었는 데 이 모두 거짓말 이었다는 것 무엇 성산포 주민 들 대초 그 같은 일이 벌어졌을 것 같으면 모를 수가 없다 해서 자체 조 사했었는 데 모두 다 새 빨 간 거짓말 이었다는 것 아닌가 증언 필히 증거 의해 뒷받침 돼야 한다	FALSE
전두환 문제	FALSE
광주 민주화 항쟁 부분 계속 밝혀 주 시기 바랍니다 다만 조국 사태 호도 하 거나 물 타기 하 거나 시선 돌리려 하지 마십시요 우리 조국 사태 제대로 처리 하는 지 문재인 정부 계속 주시 할 것 입니다 그리고 더불어 민주당 여러분 광주 민주화 항쟁 세월호 사건 정치 적 그만 우려 먹으십시요 지겹습니다	FALSE
신부 개뿔	FALSE
목격자 증언 의미 없지 ㅋㅋ 다 광주 사람 들 진실 말 한다는 보장 어딧어 ㅋㅋ	FALSE
거 봐라 ㅋㅋㅋ 엇그제 세월호 기사 올라왔을 때 내 그랬잖냐 ㅋㅋㅋ 세월호 쿨 돌아 왔으니 도 쿨 돌아 올거라고 ㅋㅋㅋ	FALSE
어쩜 일부 댓글 들 일 본 놈 들 우리 하는 말 똑같네 그만 좀 해 지겹다 언 제적 소리 보상 끝나지 않았냐	FALSE
토착 왜구 남로당 쿠 대타 차 떼기 매국노 폭도 덩년 넘 덜 데모 할 때 우리 헬기 사살 안 했다고 잡아떼 보자 비난 댓글 다는 시키 들이 뭐라고 하는지	FALSE
재 🐕🐕🐕	FALSE
잡 보수 지들 불리하면 그만 하래 싀 이 펄럼 들	FALSE
사회주의 가는구나	FALSE
나도 월세 씩 벌써 세번 째 옮기지만 ㅅㅂ 내 집 있다고 생각 해봐 누가 왜 내 세놓는걸 이래라 저래라 해야 돼 당사자 끼리 합의 되면 되는거지 사유재산 몰라 집은 집주인 꺼 남 집 맘대로 들어가 사는게 주거권	FALSE
그럼 지금 광화문 집회 당신 어떻게 설명 할 겁 각종 욕 각목 술자리 등등 좌파 우파 따지기 전 우리 먼저 자중 그런 행동 하면 막아야지 뒤 모른 척 하 이런 글 올리고 그러지 맙시 우리 책임 입니다	FALSE
미친 민좃당 집값 올리는 규제 책 웃기지도 않는 공급 억 제책 쓰니까 개 폭등 하 기 좌 빠르 들아오마 북한 뉘 우스	FALSE
이 정부 들어와서 집값 오르고 서민이 더 힘들어졌다이게 무슨 서민 위 정부	FALSE
서울 외곽 싼 전월세 매매 넘칩니다 빌라 집도 아닌가요 결국 서울 센터 역세 권 신축 아파트 살 싶다는 이야기	TRUE
무슨 공산주의 열심히 돈 벌면 죄인 투자 해서 부자 되면 죄인 가만히 백수 짓 하면 먹여 살려줘야 돼 이런 쓰레기 들	FALSE
당신 돈 많아 돈 많으면 뭐 없는 사람 위해 기부 해보셨는지 없는 사람 들 이용 하지 마시고 무슨 일 하는지는 모르지만 많으면 좀 냅시다 없는 놈 내고 싶어도 못내	FALSE
북 공짜 받은 초가집 땔감 주 스러 다 네 봐야 저 빨갱이 들 자신 들 쓰레기 였구나 할텐데	FALSE
서울 태어난게 당연히 스펙 북한 남한 태어난것도 스펙 다	TRUE
지방 태 어 낫으면 니 고향 땅 살던가 집 사 왜 서울 비싸다고 지랄	FALSE
니 비판 하려는 사람과 정 반 대 입장 다 다시 읽어 보고 댓글달아	FALSE
대치동 한 먁 사원 원장 입주다 월세 날짜 속임 돈 갈취 악덕 다단계 업자 살고있음 엉터리 영 수 학원 운영 총무 월급 제대로 계약 안함	FALSE
박근혜 때 돈 눈앞 가져다 주며 제발 사 달라 대출 다해 준다고 그 난리 쳤는데 그때 냉랭하게 외면 하더니 이제 서 뭐 하자는 거	FALSE
일단 이전태생들과 이전태생들부터 다 사살 하는게 답 봅니다 저 들이있어서 지금 집 문제 심각해진 부분 봅니다	FALSE
오마이 뉴스 표절 기사 내려 달라 청년 작가 협박 위협 조롱 게 사실 오연호 오마이 뉴스 대표 찾아온 피해자 반말 하고 화 낸 게 사실 오 대표 사과 했나요	FALSE
청년 들 모두 서울 살 필요 없다 서울 집값 비싸다고 징징거리지 지방 가서 지방 소멸 막아라	FALSE
울 나라 임대주택 너 무적 어 유럽 가 임대주택 데울나라 임대주택 몇 나 될까 집값 안정 될텐데	FALSE
전세 없애 버려	FALSE
한국인 최초 사제 김대건 신부 님 유네스코 세계 기념 인물 선정 됬다는 정말 좋은 기사 같네요 이런 기념 적 일이 앞 많이 일어나면 좋겠네요	TRUE
가브리엘 세례명 가진 천주교 신자 이자 예 신입 니 학교 주보성인 김대건 신부 님 유네스코 세계 기념 인물 선정 된것을 기쁘게 여기 있습니다 저 하루 빨리 김대건 신부 되길 바랍니다	TRUE
이 세기 나올수있는 현상 싶다	FALSE
빨갱이 공산당 자유 말 정반대 되는 말	FALSE
공산당 아니라 토착 왜구 자 한당 전신 집권 당 하던 짓	FALSE
공산당 옹호 하는 토착 빨갱이 들 개 많네 ㅋㅋㅋ	FALSE
야만스럽고 미개한 짱깨	FALSE
홍콩 힘내세요	TRUE
홍콩 응원 합니다	TRUE
가슴 아프네요 한편 개인 인권 탄압 하나 중국 주장 하는 중국 공산당 혐오 스럽구요 유엔 인권 문제 다루어 중국 정부 압박 해야 하지 않을까 싶어요	FALSE
그래도 명색 인권 편 호사 출신	FALSE
그래서 중국 리 제제 가하면 또 그 걸 욕 할인 사가 말 방구	FALSE
인권 변호사 오늘 묵묵 부답 ㅋㅋㅋ	FALSE
중국 열병 식 초대 받아 참석 분 왜 조용하시다고 생각 하시나요	FALSE
그 놈 선택 적 인권 따지는 변호사 출신	FALSE
인권 패스 카마 호 같 은애 들 변호 해줍니다 적어도 명 이상 살인 와야 문 재앙 변호 가능	FALSE
돈 표 안 돼서	FALSE
문명 시위 민주 시위 하고 폭력 쓰지 않았더라면 저렇게 진압 하지도 않았겠지 전철 불 지르고 중국 유학생 여행객 폭행 대한민국 촛불시위 세 삼 존경 스럽네	TRUE
정부 공식 입장 자제 하는게 국익 도움 된다 단 국개 들 뭐 하냐 느그 들 맘껏 떠들어도 되는데	FALSE
유럽 미국 도와줘야 하는거 아닌가 한국 지 근거리 있고 기업 들 보호 한다는 미명 아래 정부 끽소리 못 하지만 언론 제발 중국 대한 문제점 지적 하기를 이 모 다음 차례 북한 그리고 다음 차례 우리 우리 위구르 나 티벳 강간 당 강금 당 신나치즘 중화즘 찬양 하 강요 받을지도	FALSE
이대로 천안문사태 되면 홍콩도 평생 갈 일 없겠네요 점점 홍콩 불리해져가고 있지만 응원 합니다	TRUE
자 한당 홍콩정부 편 들 싸 그리 광주 학살 천안문 학살 처럼 하라 해 대가리 머 들어있는지	FALSE
휴 저 자 국민 들 할 짓	FALSE
전두환 각하 만세	TRUE
ㅎㅎㅎ 전두환 다시 집권 해서 탱크 밀어 버릴까봐 홍콩 시위 대가 한국어 된 임 위 행진곡 튼 것 알고있니 니 이렇게 댓글 다는 것 우리 홍콩 투사 들 처럼 민주화 과정 겪었기 때문 휴 아이큐 낮은 애 들 하나 하나 댓글 달아주는 것 일이	FALSE
우리 짱깨 들 몰아내자	FALSE
홍콩 민주화 공산주의 앞 곤욕 치루 구나 우리 저렇게 될 날 머 ㅡ 않았구나 젊은 이 들 정신차리거라 후회 할 땐 이미 늦었느니라 문 재앙 나라 정은 이 바쳐 버리면 이보 더하고 광주 사태 더 할것이다	FALSE
연세대 사태 비슷하네 당시 서울 중대 복무 하면서 학 내 건물 진입 할 때 엄청 힘들고 두려웠었는데	FALSE
이 바로 비극 공산당 중국 하는 짓 봐라	FALSE
피 흘려서 만든 민주주의 ㅡ 우리 해낸거다 ㅡ 그걸 부정 하는 인간 들 자 한당 인거고 ㅡ 알겠냐 Sbs 야 ㅡ 시 붕소	FALSE
시위 절대 나쁜 것 아니지만 이런 식 허무하게 사람 들 생명 위협 주는 시위 없어져야 될 것 같습니다	TRUE
전두환 각하 만세	TRUE
우리나라 집회 결사 자유 언론 자유 잘 하는 나라 얼마나 될까 아무 것 모르고 그저 전 두 화이 그리워하고 이명박 그네 타령 하는건 무슨 생각 사는 건지	TRUE
불 화살 화염병 그럼 무기 아님 그 걸 공공재 산이 불타고 인재사고 나는데 꼭 총 칼 들어야지만 무기 든건 가요	FALSE
짱꼴라 저러면 해결 되다고 생각 하 돈 많지 진짜 수준 떨어진다 한국 진짜 최대 문명국	FALSE
실패 예정 된 시위 그래도 지지 합니다	TRUE
중국 ㄱ ㅆㄹㄱ 국가 임 명실 상부	FALSE
안타깝지만 홍콩 미래 없다 떠날 사람 들 이미 탈출 남으면 그냥 중국 일부 될 뿐 홍콩 중국 입장 Shenzhen 이미 gdp 는 넘었고 이제 더 이상 매력 그닥 없는 redundant 다	FALSE
데모 진압 이렇게 하는거다 우리나라 좀 배워라	TRUE
이런 상황 미국 가만히 있구나 대통령 따라 이렇게 다르네	FALSE
하 너무 안타깝고 슬프다	FALSE
누가 조상 인지도 모르는 폭도 들	FALSE
마음 아프고 좌절 감 생깁니다 이 시대 이런 일이 생겨도 아무 도움 줄 수 없다니요	FALSE
지 들 부모 형제 들 생각 들 이안 드	FALSE
전에 서울 이랬지 경희대 앞 여름 콩국수 먹고 나오는데 눈앞 정경 들 학생 들 화염병 돌 던지고 모든 지하철 역 시민 들 가방 열람	FALSE
좀 배워라 개보 수놈 들	FALSE
홍콩 힘내세요	TRUE
안타깝네요 서구 식 생활 익숙한 마인드 공산주의 받아들이 기는 쉽지 않은데 갈등 옛날 같이 외국인 거주 특별 지역 두면 좋을텐데	FALSE
이 열 국산 도입 하자	FALSE
우리 도 울 방법 없을까	TRUE
림종석 갈 곳 이	FALSE
착한 홍콩인 이번 다 죽겠네	FALSE
전두환 나랏돈 호위 받으면서 아직도 골프 즐겁게 살다네	FALSE
민주 인권 좋아하시는 분 홍콩 문제 지지 발언 안 하시고 입 다물고 계신 이유 뭐 탈북민 북송 관련 된건 가요 통제 하는게 아닌 짜고치는 고스톱 아니면 오늘 국민 대화 이런 질문 나와야지 ㅋ	FALSE
중국 미개 이참 망해라	FALSE
정은 이 안 이럴것 같지 더할 걸	FALSE
이나라 인권 민주 투사 쳐 씨부리던 시정 잡배 셐히 들 어디 갔냐 주 뎅 쳐 닫고 찍 소리 못 하	FALSE
똑바로 봐라 공산당 정체 이러고도 중국공산당 북한 공산당 빠느냐 이 적 화 된 대한민국 모습	FALSE
도널드 트럼프 미국 대통령 오사카 시 주석 만났을 때 ‘ 홍콩 사태 이슈 화하지 않을 것 약속 했다 에는 시위 대 ‘ 폭도 riot 부르면서 “ 홍콩 중국 일부 이므로 그 들 사이 문제 ” 했다 미국 머 통령 폭도 데 머 통령 빨갱이 노 엌 ㅋㅋㅋㅋㅋㅋㅋ	FALSE
아직도 냉전시대 쳐 살 있네 공산당 붕괴 된지 언 젠데 혼자 아직도 전쟁 중 너 틀니 주 아니 넌 주간 압수	FALSE
세계 신 냉전 뭐 하는데 국제 정세 더럽게 못 읽네 짱깨 공산당 뒤졌냐 뒤져가는 중이 긴 하지	FALSE
도대체 누가 공산당 빨어 ㅡㅡ 자기 세상 빠지셧 정신차리고 선동 좀 그만해요 공산당 좋아하는 대한민국 사람 없으니까	FALSE
우리 나라 주사파 공산당 좋아한단다	TRUE
정확히 말 하면 자유 주의 권위 주의 전체주의 대립 제발 좀 알고나 떠들자	FALSE
한국 시 키 들 조 옷 아닌것 들이 일본 도 꼼짝 못 하는것 들이 세상 바꾸려 하냐 드러운 미적	FALSE
주민 주권 주장 하지도 못 받고 탄압 받는 현재 홍콩 그저 중국 식민지 불과합니다 홍콩 독립 지지 합니다	TRUE
홍콩 시민 들 가해 폭럭 중단 해라	TRUE
해외여행 다니면서 인권 팔이 하고 돌아다니던 도그 텐섹기 는 어디 갔나요	FALSE
누구 니 아버지	FALSE
쩝쩝 거리 있겠죠	FALSE
짜장면 먹으러 갔답니다	TRUE
쩝쩝 치매 심각하다 이 게 나라 진짜 쩝쩝 입장 표명 해봐라 경제 말아먹고 북 한퍼주고 여론조작 이 게 나라 진짜	FALSE
유엔 홍콩 독립 위해 노력 해 주시길 바랍니다	TRUE
근데 뭣 많던 그 민주화 투사 들 개념 연 애인 들 왜 홍콩 사태 싸 그리 아가리 침묵 중이	FALSE
문재인 공산당 미래	FALSE
민주주의 부르 짓던 전라도 정권 아닥하 만행 국민 들 지켜봅니다 니 들 이 민주화 투쟁 라면 홍콩 대학생 들 지지 중국 홍콩 무차별 진압 규탄 해야 옳다 ㅉ	FALSE
중공 눈치 보느라 안함 아니 못 함	FALSE
중국 한국 입국 금지 시켜라	FALSE
문제 심각 성은 오늘 홍콩 내일 대만 한국 일수 있다는걸 외면 하는것 혈기 넘치는 김정은 이 한국 핵 한 방 때려주고 연방제 하면 알아서 긴다는 생각 안 하겠나	FALSE
천안문 사태 다른 말 베이징 대 학살 하죠 몇 명 죽었는지는 아무 모름	FALSE
공산주의 한계 보는 중	FALSE
아 너무 슬프다 ㅠ	FALSE
한국인 명 뭐 어떻게 해볼라고 같이 시위 하러 따라갔냐 ㅈㄴ 게 웃기	FALSE
홍콩 자유 평화 지지 합니다	TRUE
시민 들 핍박하지 마라	TRUE
저 사람 사는데냐 인데 ㅎ	FALSE
다른 더 많은 시위 대가 경찰 감싸야지 그게 아름다운 모습 아니겠냐 죽창 경찰 내장 뚤 어 줘야지 보급 로 차단	FALSE
ㅋㅋ 울 나라 인권 위원회 북한 홍콩 시위 인권위 찍 소리 못 하 김정은 수령 님 노 하실라 ㅋㅋ	FALSE
공산당 증오 한다	FALSE
문 쩝쩝 중국몽 되겠숩니돠 국내 문제 질문 받지 않겠숩니 쩝쩝 쩝	FALSE
한국 자칭 진보 좌파 들 중국 찍 소리 못 하네 ㅋㅋㅋㅋ	FALSE
진보 빼 종북좌파 친 중좌 파일 뿐	FALSE
홍콩 독립 응원 합니다 ㅜ	TRUE
공산당 근성 밟아 뭉 개 버리는거 저 들 타협 단어 없다 오직 완벽한 굴종 요구 할 뿐 홍콩 미래 걱정 된다 대한민국	FALSE
홍콩도 경제 끝났구나	FALSE
건물 방화 기물 파손 하는 순간 부터 홍콩 시위 실패할수 없었다 최고 무기 평화 시위 팽개 폭력 집단 화 되었 버렸는지	FALSE
너무나 마음 아프다 홍콩 민주주의 만세	TRUE
어디 폭동 비교 하나요	FALSE
미성년 자 몇 백 명 있었다구 중 병 이렇게 무겁습니다 영화 조커 따라 한 것 뭐 ㅉㅉ	FALSE
참 단순하게 사고 해서 좋겄다 먹고자고 니 밥처 먹은거 설겆 해	FALSE
자국 지키는데 나이 중요한가 침묵 하는 어른 들 존경 스럽구만	TRUE
드론 이용 해 생필품 지원 해 주자	TRUE
지속 적 평화 시위 하시기 바랍니다 삼일운동 진행중 광화문 시민혁명 동력 시민 자발 적 참여 평화 의지 시민 운동 이자 혁명 합니다 폭력 더 큰 폭력 낳으며 승자 패자 없습니다 그러니 홍콩 비폭력 시민혁명 세계 요구사항 호소 하며 하나 하나 이뤄 나가야 합니다 비폭력 지속 될 수 있고 공감 받을 수 있으며 지지 받을 수 있습니다 홍콩 자유 기원 하며	TRUE
공산당 상대로 에고 중국 먹고살만 하믄 저절로 민주화 된다 성급하게 그러지말고 기다림 어떨지 시진핑 사후 민주화 될려나 그냥 시킨대로 하믄서 살어	FALSE
한국 일본 다 가둬 버리지 남말하기 좋아하는것 들	FALSE
홍콩 전략 무기 무상 원합시다 미사일 좋고요	TRUE
효 중국 흑사병 창궐 한다는데 홍콩 저렇고 진짜 민폐 국 클라스 쩐다 중국 때문 연일 시끌시끌 난리 아니구나	FALSE
삼청교육대 필요합니다 박찬주	FALSE
Freedom is Not Free Korean People Support You Hong Kong	TRUE
인권 변호사 나설 때	TRUE
홍콩 안녕	TRUE
이제 미국 나서야 할 때	TRUE
여러분 이 정말 얼마나 경악 스럽고 끔찍한 일 인지 상상 가세 홍콩 이 공대 홍콩 유동 인구 가장 많은 침사추이 차로 가면 걸어가면 거리 있는 말 그대로 핵심 번화가 있는 대학교 우리나라 생각 하면 강남역 기준 신논현역 정도 위치 있는 대학교 전면 봉쇄 저격수 동반 무장경찰 진 친채 최루탄 물대포 쏘고있는 겁니다 이 을 한 달 앞둔 인간 모습 요 참 슬픕니다	FALSE
영상 봐도 암담한데 홍콩인 들 오죽할까	FALSE
우리나라 과거 깨어있는 학생 들 민주화 운동 많이 했었는데 도와줄 방법 없어 안쓰럽고 참담합니다	TRUE
홍콩 이리 끝나는 건가	FALSE
그래도 중국 제품 불매운동 안 하겠지	FALSE
빨갱이 들 큰 형님 짱개 요	FALSE
개 소수 민족 들 공산주의 다스리는 나라 중국 강압 정책 이길수 없다	FALSE
프리 홍콩 남일 아니다 중국 전세계 민폐 끼치고있다 즉각 중단 하	FALSE
반중 불매 해야지요 여러분 왜 안 하세요 부모 짱 깨거나 아님 간첩 빨갱이 그 런가	FALSE
어쩔 수 없다 홍콩 중국 땅 것 ㅡㅡ 나라 싫으면 떠날수밖에 없는데 냉정히 떠난다고 받아줄 나라 있을까 싶다 미국 봐도 자국 우선주 개 소리 짖 걸이는데 설령 돈 있어 이민 간다 해도 인종차별 어쩔 수 없지	FALSE
지금 일국양제 체제 저러는 거임 홍콩 땅 중국 소속 됐지만 정치 행정 별개 식민지 취급 하는 거임 ㅠ	FALSE
글 솔 까 중국 계 전세계 나가 살기 때문 인종차별 많지 않은 ㅠ	TRUE
무슨 일국양제 체제 식민지 취급 받고 쫓겨나 난민 되라는 거	FALSE
광주 자체 무장 했어야 했나 무장 없으니 맥 없이 끌려가네	FALSE
ㅋㅋ 무장 한 게 자랑 그게 민주화 무기고 털어서 같이 죽이는게 그러면서 학살 개 소리 좀 지껄이지 마라 버스 군 죽여놓고 민주화 운동 과정 일어난 일이 무죄 ㅋㅋ	FALSE
이제 홍콩도 불매 해야 하는 건가 해야겠지	FALSE
중국 불매 아니고요	FALSE
no 홍콩 여행	FALSE
홍콩 폭도 되면 최고 징역 형 우리나라 폭도 되면 유공 자 지정 되어 학비 면제 전기 수도 감면 취업 지원 병원 비 지원 받는데 ㅠㅠㅠ	FALSE
일베충 왈 曰 “ 역시 흉 폭한 폭도 들 말 몽둥이 특효약 ”	FALSE
우파 홍콩 응원 다 좌파 공산주의 존재 하는 공 수 처 입 올리는거고	FALSE
좌파 우파 둘다 필요 없음 둘다 세뇌 된 것 들임 누가 요 세 세뇌 된 사람 다 들 뒤 비웃지 공 수 처 검찰 장 직선제 일 미 독 전부 ㅋㅋ 쯧쯧 그리고 프랑스 가 공산당 알 긋냐 세뇌 당하 신분	FALSE
남조선 핵폭판 터뜨려라 정은아 기회 내정간섭 하는 놈 들 싹 다 쓸어 버려아	FALSE
시위 대가 아니라 폭도 들	FALSE
조슈아 윙 어디 갔노 선거 박탈 되서 집 있나	FALSE
홍콩 언론 출판 자유 없애고 서점가 반중 운동 들 몰래 뒤 잡아가 실종 되는 것 현실 대륙 젊은이 들 속지 마라 그리고 응답 하 홍콩 젊은이 들 희생 그대 들 응답 위 것 대륙 들불 일어나기를 소망 하며 지금 유서 쓰고 결사 항쟁 있다	TRUE
现实情况是 香港取消媒体出版自由 在书店里的反华运动家们偷偷地从背后抓 最后失踪 大陆的年轻人 不要上当受骗 还有请回答 香港年轻人的牺牲是为了你们的回应 盼大陆如野火起 至今犹书誓师	FALSE
대륙 젊은이 들 다 세뇌 당 개돼지 들 뿐인데요 ㅋㅋㅋ	FALSE
유엔 왜 입 다물고 가만히 있는걸 까요 이미 중국 팔린건 가요 궁금해서요	FALSE
평화 시위 라면 유엔 아니라 할애비 나서겠는데 저렇게 폭력 적 시위 하 유엔 나서질 못 하는거야 유엔 나서면 폭력 시위 조장 저 시위 대 넘 들이 사 제 폭탄 만들겠다고 했으니 더 큰 대형 사고 터지 기전 진압 하는게 최선 책 이란다	FALSE
저 중국 한계 응원 합니다 홍콩	TRUE
저 시위 대 넘 들이 난리 피는거지 저 뭔 난리 그냥 시위 안 하면 아무 난리 없는거잖아 정신 나간 너 마	FALSE
중공 엮이 이렇게 됨 문 재앙 중공 몽 아직도	FALSE
중공 놈 척살 하자	FALSE
시진핑 전두환 따라갈라면 아직 멀었네 한국 역사 공부 좀 더하고 와라	FALSE
이 놈 중공 놈	FALSE
내란 선동 폭력 시위 일삼 는것 들은 군화 발 밟아 버려 야함 우리나라 보고 좀 배워라	FALSE
홍콩 불법 폭력 집회 최후 ㅋㅋ 그러게 국가 안보 왜 어지럽히나 양키 들 영혼 팔고 ㅋ	FALSE
이제 홍콩 생지옥 될 것 행정 장관 게 정신 못 차리고 중국 공산당 홍콩 공산당 내주다니 민주주의 체제 지키려는 어린 대학생 들 선한 눈동자 보이지 않는가	FALSE
지금 전세계 폭력 시 위로 들끓고 있다 남미 사회주의 지지 시위 대가 도심 다 때려 부수 있고 프랑스 선 노란쪼끼 시위 대 스페인 아일랜드 독립시 위대 등등 그 중 제일 더럽고 지 저 부리 하 시위 하는것 들이 바로 홍콩 시 위대 들 홍콩 시민 들 지지 못 받으니깐 왜 홍콩 시민 들 패 버리는 아주 나쁜 넘 들이지	FALSE
안타깝지만 홍콩 이미 중국 복속 되었다고 본다 앞 중국본토 같은 감시 색출 시작 될듯	FALSE
대 깨문 새끼 들 너 네 꿈꾸는게 이런 거더	FALSE
시민 들 탄압 하지 마라 니 들 사람	FALSE
너무 안타깝습니다	FALSE
故 백 남 기씨 두개골 최소 곳 심한 골절 상 물대포 맞아선 생길수 없어 입력 당시 주치의 서울대 백 선하 교수 측 기자회견 망치 강하게 수 차례 맞거나 車 치여 몇번 구르는 정도 여야 생겨 법원 유족 측 별다른 증거 제출 안 했는데 백씨 사인 경찰 물대포 단정	FALSE
가짜 뉴스 기레기 짓 자본금 대납 임원 사장 나와서 무릎굻 사과 해	FALSE
시위 앞 더 쎄질것이다 폭력 끝 폭력	FALSE
사람 비행기 떨어져도 되고	FALSE
이병헌 실제 모델 닮았넹 ㅋㅋㅋ	TRUE
프랑스 언어 발음 앞 사람 홀리 뒤 빨대 꽂아 진 빼먹는 천 사 얼굴 악마 ADHD 환자 들 순진한 척 안 하면 덜 걸려 들텐데 고개 숙이며 예의 바른 척 하는 일본인 같다하여 외국 모이 다 들 피 하는게 프랑스인 룰 없어 섹 싶으면 그냥 달려든다 친구 남편 ㅋ	FALSE
박정희 덕 이 젠 프랑스 러시아 오스트리아 우리 인간 개발 수도 높은 선진국 됐다 투표 잘 해라	TRUE
도대체 쟤 들 클스마스 뭐 하는게 왜 그리 궁금한거죠 기자 님 북한 추종 자세 대변인 이세	FALSE
이 걸 기사 쓰나 저기 진실 얼마나 된다고 보는지 휴 왜 저런 장난 한국 언론 춤 추는지	FALSE
북한 뿐 아니라 아시아 크리스마스 공휴일 나라 몇 없는데요 이웃 나라 일본도 공휴일 아닙니다	FALSE
저 진짜 무지한거라니까 성탄절 세계 휴일 아니지 그걸 당 연 시 허는게 이상한거 아니가	FALSE
Jaeg 그런 망언 설 추석 왜 중공 명절 지내는 방식 다른데	FALSE
대한민국 있게 한 바티칸 미국 기독교인 들 감사하는 뜻 공휴일 유엔 데이 공휴일 이었다 지금 아니지만	TRUE
기독교 본 산 유럽 이제 성당 교회 사람 없는데 엉뚱한 아시아 극동 국가 성당 교회 미어 터지고 되지도 않는 라틴어 성가 서양인 얼굴 예수 성모 상 앞 머리 조아림 코미디 아님	FALSE
원래 은 예수 태어난 날 아니다	TRUE
사생아 생일 알아야하나 ㅋㅋ 마리아 알 있을듯	FALSE
여기 북한 출근	FALSE
ㅋㅋㅋㅋ 웃었다	TRUE
무슨 공휴일 대한민국 평일 근무 하는 회사 있다 멀리 가지마라 바로 옆 있으니까 이 것 기사 구	FALSE
북한 성탄절 평일 것 충분히 그럴 수 있지요	TRUE
아기 예수 탄생 그래서 전 세계 축제 우물 안 사는 끼군 무슬림 힌두 불교 들으면 웃지	FALSE
크리스마스 날 왜 공휴일 된 겨 예수 태어났든 말았든 울 나라 뭔 상관 있다고 사생아 생일 맞긴 맞어 마리아 물어 봉겨	FALSE
북한 무슨 종교 자유 있니 대 독재 국가	FALSE
뉴스 써 있자나 북한 먼저 믿고 지금 있다고 그리고 아마 기억 김일성 엄마 기독교 였을 껄 걔네 김일성 자체 신격화 하잖아 아마도 난 북한 몰라서 잘 몰르겠당	FALSE
헌법 국교 부정 하는데 종교 기념일 공휴일 잘못 된거 나라 기념 할 일 들 그렇게나 많은데 단 두 종교 특혜 주는거도 이상 한일	FALSE
여기 일본도 그냥 평일 출근 디	TRUE
다른건 둘째 저건 진짜 잘 하는거다 구 구 절절 오만 쉰 소리 넋 놓고 앉아 집 있는 애비 애 미 놔두고 엎드려서 아버지 아버지 집 있는 부모님 들 그렇게 해봐라 업고 다닐거다 뜨신 밥 먹고 무슨 헤수스 쉰 소리 타령	FALSE
북한 출근 하나요 한국 출근 사람 많아요 우리 회사 직원 들 다 나와서 일해 스케줄 근무 회사 다 나와서 일해	FALSE
각 나라 문화 적 주체 적 사상 있지 남 종교 문화 뭘 그리 좋다고	FALSE
난 북한 사람	TRUE
쥥국 마찬가지 입니다	TRUE
중국 정상 출근 한답니다 기자 북한 모르나 봐	FALSE
의미 없다	FALSE
저 도출 근 햇 어	TRUE
장례 관계자 들 크리스마스 출근 합니다 물론 지하철 공익 들	TRUE
이 걸 알아야 함 출근 개 긋네	TRUE
누가 보면 북한 공휴일 아닌 걸 알겠네 한국 홍콩 마카오 공휴일 가 아시아 쪽 있나	FALSE
북한 참수 작전 안 하냐 누가 문재인 치매 새 기 좀 어케해바 ㅡㅡ	FALSE
종교 자유 없는 공산주의 좋아하는 넘 들은 북 가라	FALSE
같은 민족 은 차이나네	FALSE
중국 평일 임	TRUE
응 거기 다른 세상 그런 거지 ￣◇￣	TRUE
크리스마스 헬 조선 고유 명절 아닙니까	FALSE
내 지금 평양 입네다 성탄절 휴일 아니지만 그래도 분위기 납니다래	TRUE
한국 기자 들 초등학교 수준 한국 명 문 대학 중국 고등학교 수준 박 안된다	FALSE
안녕하세요 중국 천진 입니다 출근 했습니다 ㅎㅎ	TRUE
우리나라 굳이 쉬는 날일 필요 없다 성탄절 하지만 예수님 온데 간데 없고 선물 주고 받고 술 빠져 흥청망청 하고 이성 하룻밤 위해 눈 벌개져서 돌아다니는 것 보면 성탄절 의미 퇴색 한지 오래 다 꼭 쉬는 날 아니어도 성탄절 의미 제대로 아는 사람 들 알아서 예배 미사 드린다 따라서 성탄절 평일 만들어서 이상한 분위기 들 싹 없애고 진정 예수 그리스도 탄생 기뻐하는 사람 들 의해 진짜 성탄절 회복 시키는 것 낫겠다	FALSE
그 와중 북한 걱정 하노 ㅋㅋㅋㅋㅋ	FALSE
이 뉴스 보던 빤 쓰 추종자 들 어라 공산주의 믿는 북한 무조건 지옥불 떨어져야 하는데 어라 하나님 믿는 우리 천국 가는데 똥꼬 뇌 들 대 환 장 파티 중	FALSE
봉건 왕조 일제 식민지 거쳐 극도 고립 된 인민 들 스딸린 부터 틀 배우고 더 지독히 속 채운 김일성 이제껏 지구 상 존재 하지 않았던 악마 세습 정권 만든 곳 어떻게 인민 들 매주 생활 총 화로 서로 비판 하게 하고 감시 하며 고발 국내 여행 승인 받아야 하는 나라 만드 이런 집단 대해 명색 인권 변호사 이자 민주화 운동 했다는 사람 비판 한 번 못 하나 가짜 아니고 거짓 아닌가	FALSE
우리나라 출근 많이 하는대 더군다나 공휴일	TRUE
나도 평일 ㅜㅜ	TRUE
아시아 쉬는 나라 더 드물다 일 본 중국 다 일 하는데 북한 무슨 상관 ㅋㅋ	FALSE
남조선 동무 일 한 다지 비	FALSE
부칸 어디 있는 곳	FALSE
우리 구세주 예수님 찬양 하며 예수님 닮아가는 모두 되 기를 소망 합니다	FALSE
망국 당 빤 스당 올엔 안 보는거로 암 아멘 나무아미타불	FALSE
윗 분들 축복 아니라 저주 선택 하셨군요 저주 선택 한자 저주 늪 살이 갈기 갈기 찢기고 뼈 발라질 것 회계 하	FALSE
미쳐 ㅋㅋ	FALSE
빨 개신교 그토록 원하는 천국 빨 데려가 쇼 개 나소 계시 남발 하지말고	FALSE
광화문 대 대적 성탄 연합 예배 하던데 그건 보도 안 하네요	FALSE
평화 빕니다	TRUE
■ 새해 문재인 탄핵 되서 대한민국 희망이 찾아오길 기도 합니다 ■	TRUE
종교 갖고 있다고 딱히 더 도덕 적 이 지도 자비롭지도 않지만	FALSE
전광훈 목사 따르는 사람 들 과연 하느님 논 할 자격 있나요 욕 폭력 쓰고 난동 선동 나라 민폐 막심 한 데 어떻게 예수 사랑 논 할 자격 있는지 모르겠다	FALSE
🦁 손녀 빤스목사 대화 🍗 손녀 ㅡㅡ 할아버지 왜 사람 들 빤스 목사 빤스 목사 그러는거야 빤스 목사 ㅡㅡ 사실 내 여자 성도 들 “ 빤 ㆍ 스 내려라 해서 그대로 하면 내 성도 거절 하면 내 성도 아니다라고 했어 ㆍ🍗 손녀 ㅡㅡ 변 ㆍ 태 ㆍ 새끼 빤 스 목사 ㅡㅡ 미안하다	FALSE
역시 광화문 한기총 성탄 예배 뉴스 싥지 않는군요 그러니 무슨 반 목 단어 쓰는 감 ᆢ	FALSE
빤 스 벗고가야하나 입고가야하나 사이비	FALSE
광화문 연합 예배 참석 하러 경남 가는 중 입니다 기자 님 제발 공정하게 정의롭 기사 써주세요	TRUE
세상 모든 선한 사람 들 아프지 않게 나쁜 일 없게 행복하게 살 해주세요 특히 어린 아이 들 행복한 은혜 베 푸소서 🙏 복 눈덩이 불어나서 행복하게 살 해주세요	TRUE
★ 하나님 교회 정치화 하여 권력 쟁취 모금 하여 부자 되고 가난하고 힘없는 자를 외면 하 가르치신 일이 있더냐 ★ 아멘 †	FALSE
삐 딱한 소리 하지 빨리 교회 가서 너 싫어 하는 예수님 이름 세례 받고 회개 해야 구원 받는단다	FALSE
예수님 길 걷는자는 친구 형제 성경 나와있음 그리고 하나님 예수님 임 그렇기에 그렇게 말 한 것	FALSE
하나님 사랑 공 의 상징 창조주 이 시 그런데 그런 하나님 자신 들 사상 재단 것 들 바로 천주교 개신교 내 속칭 좌파 목사 들 자칭 천주교 인 문재인 그 하나님 말씀 하신 사랑 실천 하였는가 그 정의 언행 베풀어 왔는가 오직 거짓 오만 점철 된 문재인 그 패거리 하나님 가장 싫어하시는 유형 인간 또한 감히 하나님 말씀 왜곡 하며 교인 들 선동 하는 좌파 목사 것 들 하나님 능욕 하는 악한 존재 하나님 사랑 변함 없듯 하나님 정의도 변함 없다 때 대상 잣 대 동등 하다	FALSE
종교 을 정치 ㅜ 연관 시켜 좌파 연관 짓는 님 사상 참 대단하네요	TRUE
천주교 자비 뭔 지 아십니까	FALSE
◆ 가난 한자 들 아방궁 빗까 번쩍 하 으리 으리 교회 가서 기도 하는 척 하며 교홰 어떻게 돈 버는지 보고 배워라	FALSE
🥦 사탄 빤스 목사 망언 🏈 문재인 하나님 폐기 처분 했어요 🏈 대한민국 누구 중심 돌아가는 것 전광훈 목사 🏈 나 기름 부음 이 임 했다 🍆 나 하나님 보좌 寶座 를 딱 잡고 산다 하나님 꼼짝 마 🍆 하나님 까불면 나 죽어 내 이렇게 하나님 친하단 말 친해 "https://n.news.naver.com/article/001/0011264668	FALSE
성탄 미사일 쏘아라 돼지	FALSE
미세먼지 그쿔 ㅠ	FALSE
크리스마스 아침 악플 들 달고있고 인생 들참 한심하다 ㅋㅋ	FALSE
🍆 빤 ㆍ 스 목사 전광훈 명언 🦁“ 여자 성도 빤 ㆍ 스 내려라 해서 그대로 하면 내 성도 거절 하면 내 성도 아니다 🦁 만약 이명박 후보 찍지 않으면 내 생명 책 지워 버릴 거야 🦁 박원순 선택 시민 들 정신 다 돌아 🦁 총격 가해 죽인다 저런 대통령 살려 두겠느냐 🍳 예수님 낮은자 ㅡ 천 한자 ㅡ 병든자 ㅡㅡ 가난한자 ㅡㅡ 들 편이었는데 ㅡㅡ 저 놈 논리 하면 예수님 빨갱이 ᆢᆢ	FALSE
광화문 갑시다 사악한 무리 예수님 뜻 전 합시다 우리 주 예수님 재림 속히 오시길	TRUE
자비 부처님 관련 된 단어 아닌가	FALSE
거리 성탄절 없어져서 차분해서 살겠다	FALSE
응원 합니다	TRUE
아이 혼자 열심히 기른다는것은 충분히 책임감 있고 훌륭한 일 입니다 응원 합니다	TRUE
넘 멋진 분이시네요 아들 더 당당해지세요 충분히 그럴 자격 있으세요 아들 엄마 정말 멋진 분 아빠 그늘 힘들어하거나 고개 숙이지 말아라 그 어떤 부모 멋진 엄마 계시 응원 합니다	TRUE
한부모 로써 책임감 있게 열심히 살아가시네요 행복한 엄마 아이 행복한 가정 이루시길 바랄게요	TRUE
응원 합니다	TRUE
부부 아이 키우는 것 정말 힘 든데 어린 나이 아기 키우겠다 결심 키워오기까지 얼마나 힘들었을까 여자 약하지만 엄마 이름 붙으면 못 할 일이 없어지는 것 같아요 멋진 모습 응원 합니다	TRUE
저 헤어지고나서 임신 사실 알았어요 아이 아빠 계속 지우자고 하더군요 전 마음 먹었기 때문 저 흔들리고 싶지 않아 연락 끊자고 했고 정말 서로 연락 하지 않았어요 두 달후 연락 서 이제 결심 했으니 함께 하자 왔는데 전 아직도 깊은 상처 때문 옆 있어도 마음 아픕니다 다음 달 출산 우리 어떻게 될지 아직 모르겠네요 아직 그 사람 온전히 받아들일수가 없어서요 제 혼자 기르기로 마음먹고 준비 했을 때 민채 씨 주변 다 알리 당당하게 시작 하고자 했어서 사실 얼마나 외 힘든 일인줄 잘압니 응원 합니다	TRUE
대단하세요 아이 가져 본 엄마 라면 압니 아이 홀로 낳기로 결심 일이 얼마나 대단한지 동시 아이 낳아 보면 압니 세상 내 아기 너무나 사랑스럽고 한 없이 예쁘다는 걸 힘내세요 사람 만드는 일이 인류 대단한 공헌 입니다 분명 좋은 엄마 멋진 엄마 되실 겁니다 많은 사람 들 함께하고 응원 한다는 거 잊지 마세요	TRUE
예쁜 사람 너무도 당연한 결정 하시고 당당하게 살 계시 그렇지 못 사람 들 많은 속 당신 아이 더 예쁘게 빛날 겁니다 그래서 복도 많이 받으실거고요 마음 예뻐서 행동 예뻐서 게다가 얼굴 예뻐서 잘 생긴 아들 응원 합니다	TRUE
민채 씨 젊은 사람 대단해요 뇌졸중 장애인 되어 보니 보는 사람 어찌 그리 궁금한것이 많은지 장애인 된 아내 버리지 않는 남편 이상하다하더라구요 ㅠㅠ 수준 들 그것 안되니	FALSE
응원 합니다 자존감 높고 똑똑하기도 하고 현명하기도 하고 성실 책임감 있고 꿈 건강하고 참 좋은 엄마 요 열심히 살아줘서 감사해요	TRUE
저리 당 차고 예쁘고 멋진 여자 놓친 애 아빠 바보 네 서로 틀림 아닌 다름으로 인정 하는 분 들 많아 젔으 좋겠습니다	TRUE
응원 합니다 참 보기 좋아요 편견 많은 나라 대한민국 아마도 제일 일듯 합니다 나이 학력 결혼 직업 이 모든 정해져있는 규칙 있는 것 아닌데 남 들 조금 다르면 시선 달라지는 게 참 답답할 뿐이져 민채 씨 당당한 사람 들 많아지면 세상 달라지리라 생각 합니다	TRUE
대 주부 살면서 지금 딱히 존경 하는 인물 하나 없었는데 글 읽으며 뭉클해지면서 대단하고 존경 스럽다는 생각 절로 듭니 아이 키우는 엄마 로서 건강한 자극 환기 되었어요 부디 앞 행복하세요	TRUE
훌륭한 엄마 한 명 열 아빠 안 부럽네요 대단해요	TRUE
나이 오십이 넘으니 인생 남 들 꼭 같아야 할 필요 없다는걸 알겠더라 자기 인생 스스로 결정 해 나아가는거 그게 정답 정답 찾는게 가장 힘들다 어리지만 훌륭하네요 힘 네 세	TRUE
응원 할께요 각자 아이 혼자 키우게 된 이유 달라 홀로 아이 키우는것이 얼마나 무섭고 힘 압니 늘 건강하시길 바랍니다	TRUE
참 사회 웃겨요 결혼 해서 아이 낳으면 정상 혼전 임신 해도 결혼 하면 정상 혼전 임신 해서 버림 받으면 비정상 참 웃겨요 누가 진짜 편견 갖고 사는지 생각 해볼 문제 입니다 혼전 임신 해서 버리는 아빠 엄마 비겁한 겁니다 키우는 엄마 아빠 책임감 있는 거구 뭘 제대로 된 지식 가지 훈계 하시든 가 자신 들 기준 맞는듯 말 하는 이상한 세상 한국 그런 기준 판단 하면서 왜 아직도 양육비 강제이행 명령 국가 못 해주는지 의문 듭니 무책임 국가 첫 번째 하고 있는 겁니다	TRUE
너무 멋지네요 아이 둘 키우면서 힘들다고 아이 들 짜증 내고 화 내는 제 자신 부끄럽네요 아이 이런 멋진 엄마 있어 행복하겟네요	TRUE
사진 넘 예쁘다 당신 무책임한 게 아니라 정말 책임감 강하고 용감한 거 잘 하셨어요 정말	TRUE
멋있어요 자신 삶 긍정 주체 적 사는 그 모습 아들 보기 훌륭한 롤모 댈이 될것 같아요	TRUE
얼굴 마음 이쁘고 멋지십니다 훗날 아들 열심히 살아온 엄마 자랑스러워하실 겁니다 응원 합니다	TRUE
당당하게 헤쳐 나가는 모습 멋지세요 응원 합니다	TRUE
민채 씨 응원 할께요	TRUE
멋있다 응원 합니다	TRUE
민채 씨 참 자존감 강한 사람 요 삶 큰 자산 이자 아이 분명 좋은 영향 될 겁니다 때론 힘든 일도 있겠지만 힘내시고 당당한 민채 씨 응원 합니다 ♡	TRUE
존경 합니다 그리고 응원 합니다	TRUE
진심 응원 합니다 그저 다를 뿐 틀린것이 아닌데 말 이 아이 들 더욱더 다름을 교육 흑백 아닌 다양한 세상 있 음 알리는것이 어른 임 다시 느낍니다 다름과 틀림 차이 구분 하는 성숙한 사회 되길 존경 합니다	TRUE
우리 괜찮은데 여러 형태 의 가정 있는데 사회 내버려 두지 않네요 아이 학교 행사 등등 우리 괜찮은데 말 이 정말 비슷한 환경 와 닿네요 우리 힘내요 아자	TRUE
당신 우리 똑같은 엄마 입니다 때 부족하지만 아이 사랑 하는 마음 낳고 기른 우리 똑같은 엄마 입니다 같은 엄마 로서 당신 삶 또한 응원 합니다	TRUE
멋져요 화이팅 👍	TRUE
씩씩해서 더 이뻐 보입니다 어린 시절 무서운 일 이었을텐데 쉽지 않은 결정 씩씩한 극복 모두 대견하고 고맙네요 잘 했어요 애기 엄마	TRUE
떳떳하게 사세요 땃떳 하 사 나기 죽어 사나 세상 그대로 입니다 그러니 이왕 그럴 바 떳떳하게 사는게 좋 디 그리고 미국 사람 들 사적 질문 하면 실예 하는데 우리 사적 것 잘 묻지요 문화 적 차이 같아요 우리 그런 것 고쳐야 할 것 같네요	TRUE
공감 되요 이제 내 행복해야 아이 행복하다 마인드 키우고 있어요 힘든 일 지나가기 마련 넘기는 법도 배우니 주변 많이 단단해 졌구나 하네요 앞 같이 응원 스스로 당당해져요	TRUE
무엇 흔들리 않을 강인한 정신 력 소유자 네 소신 있어 보이 앞 그렇게 주욱 응원 합니다 행복하세요	TRUE
정말 대단하고 훌륭한 엄마 네 저 한부모 가정은 아니지만 같은 엄마 로써 본받을 점 많은것 같습니다 이루고자 하는 꿈 꼭 이루시고 성공하시길 바랍니다 응원 할게요	TRUE
책임감 있게 자신 삶 살아가시는 모습 아름답습니다 많은 사람 들 기사 읽고 편견 버렸으면 하네요 그러면 다양한 사람 들 좀 더 당당하게 세상 살아갈 수 있을테니까 요	TRUE
최고 누구 비교 할수 없는 훌륭한 엄마 강인한 여성 요 존경 해요	TRUE
너무 야무지시고 똑똑한 여자 네 정말 잘살수 있을거예요 응원 합니다	TRUE
안 키운다 해도 옆 응원 해줘 야할 판국 정말 욕 나오네요 그리고 대단해요 여자 혼자 그것 어린 나이 키울 생각 한단 대단하네요	TRUE
가슴 먹 먹 함 응원 해드리고싶은 마음	TRUE
선하고 당당한 삶 응원 합니다	TRUE
응원 합니다 앞 모든 일이 잘 되실거에요 멋지세요 당당하세요	TRUE
엄마 아이 너무 귀하고 예쁘네요 항상 하나님 사랑 보살핌을 받으시길	FALSE
괜찮습니다 우리나라 사람 들 인식 바뀌어야 합니다 저출산 문제 하면서 ㅠ	TRUE
중요한건 다수 자 소수자 배려 감싸는건 맞는데 어쩔 수 없는 소수자 자의 적 소수자 사회 적 정의 윤리 맞게 자중 할 필요 있습니다	TRUE
응원 합니다	TRUE
자랑스런 엄마 네 감사합니다	TRUE
힘 네 세	TRUE
힘내세요 응원 합니다 끝 화이팅 입니다	TRUE
어린나이에 참으로 귀감 되네요 아이 함께 건강하고 행복하고 예쁘게 사시길 깊히 발원 합니다 ♡♡♡♡♡	TRUE
당신 선택 응원 합니다 내 삶 되 돌아 보게 되네요	TRUE
사회 소수자 라면 누구 느끼죠 장애인 성소수자 편 부모 다문화 가정 등등 다수 자 가해자 되는 경험 언젠가 는 어떤 부분 누구 소수자 될 수 있어요 조금 씩 이해 하며 살아요	TRUE
대단합니다 그 책임감 그리고 노력 더 편하게 살면서 현실 불평 하는 저 반성 하게 되네요 ㅜㅜ	TRUE
메리크리스마스	TRUE
평화 이 땅 평화 국민 분열 시킨 문재인 구속 해야 온다	FALSE
우리 인류 인문학 들 몰라도 너무 모른다 이일 어찌 해야하겠는가 도대체 이일	FALSE
꼴 페미 들 염 추기경 님 말씀 새겨 들어라 의무 외면 권리 주장 하지 응 세계 유일 분단국가 인구 절벽 앞둔 시점 여자 들 남자 들 복무 기간 보육원 양로원 의무 적 근무 하게 하자 그 리하 나라 큰 힘 될 것 이니라 o b ★	FALSE
쓰레기 개 독	FALSE
평화 미군 철수 국군 감축 적 화 통 일 이 룩 하자	TRUE
쓰레기 kbs 야 언제 기독교 나팔수 할거냐 영국공 영 방송 기독교 허상 국민 알리 국민 계몽 했다 니 들 수신료 받을 자격 있다고 생각 하니	FALSE
가짜 선동 북한 중국 하세요	FALSE
이 단 종교 이스라엘 가서 믿으세요 한국인 노아 자손 절대 아닙니다	FALSE
성당 교회 절 사찰 속 하지 마라 잘난 너 사탄 마귀 죽음 길 들어 가게 하는 집단 그 끝 죽음 뿐 없기 때문 메시아 장 절 나이 들 누구 외로움 질병 늙음 죽음 벗어날수 없고 벗어나려면 젊 어서 건강 지키며 살 가야 합니다 세 숫 대야 따뜻한 물 받아 앉아만 계십시오 좌욕 건강 지킬수 있습니다 오전 오후 이상 매일 실행 하십시오 젊 어서 代 건강 지키며 살아야 질병 고통 죽음 불행 벗어나 살 갈수 있게 되는 것 입니다 .http://blog.daum.net/mbbbk	FALSE
원 시시대도 아니고 종교 무슨 종교 종교 것 없다 종교 선량한 사람 들 눈 멀게 하여 죽음 길 들어가게 하는 범죄 저질르고 있는 것 우리 알 믿고 있는 종교 잘 이해 되지 못 한것을 모르고 잘 이해 된것으로 알 믿고 있는 것 오랜 과거 오늘날 전래 되어 관습 화 하여 문화 화 化 하고 우리 일상 생활 행 行 하여진 것 이기 선입관 판단력 부족 사고력 부족 많은 사람 들 무의식 무비 판적 받아 드리고 종교 빠져 살다 죽어 가고 있는 것 입니다 기름 부음 이 임 하나님 종 메시아 말씀	FALSE
즐거운 크리스마스 보내세요	TRUE
교회 오 바 해서 한 집 걸러 한 집 왜 사랑 온정 전혀 느껴지지 않으까 요	FALSE
명치 ㅈㄴ 쎄게 한 대 때리고싶다	FALSE
이제 좋아요 조작 하는거냐	FALSE
No 달창 빨갱이 찍지 않습니다 민주 공산당 빨갱이 없는 깨끗한 대한민국	FALSE
본인 들 끼리 서로 생각 하겠지 생각 이념 틀리면 끝 물어 뜯고 상처 깊게 주려는 인간 들 그리고 피 묻은 이빨 손 뒤 숨긴 체 가식 적 미소 선량한 채 지 들은 아닌거처럼 행동 하는 이중인격 자 들	FALSE
이 젠 「 좋아요 」 조작 하는거냐	FALSE
탈 원전 국가 손실 넘는다 도룡뇽 죽는다고 터널 못 뚫게하던 문재인 태양광 사업 수 십년 거목 초토화 잦 은비 토사 유출 산사태 빈발 사대강 극렬하게 비판 하던 그 주둥이 들 어디 사라졌나 알릴 레오 유시민 좆 티비 씨 손석희 게 그 양 아치 김제동 다 들 어디 사라졌나 응	FALSE
문 이 쌕 끼 는 북한 더블 어 사는게 소원 인 갑다 저 말 씹 블 이 조 딩 발 훅 차고싶다 옆 있다면	FALSE
좌표 찍혔네 좋아요 봐라 대 깨문 들 ㅋ	FALSE
총선 여론 조작 위 테스트 같음	FALSE
너 천주교 신자 게 너무 쪽팔린다 가식 적 사악한 인간 문재인 고해성사 죄값 치루러 가자	FALSE
근데 말 그렇게 하면서 왜 문재인 니 김정은 진핑 독재 살인마 들 굽신 거리 친해지고싶어서 따라 댕기 시진핑 김정은 평화 서로 생각 하는것과 정반대 있는 인간 들 아니니	FALSE
예수 독립 뭔 상관	FALSE
새해 뒤 재앙 문지 해주세요	FALSE
그렇게 될 겁니다	TRUE
쪼구기 구속 되느니 어쩌 하던데 참 구속 되느니 어쩌 하는 사람 법 장관 시켰다니 내년 성탄절 얼굴 안 봤으면 좋겠다 내년 총선 국민 심판 받을꺼 같은데 그 전 하야 함 용기 울듯	FALSE
즐거운 성탄절 문재인 저 새끼 쑈 왜 뉴스 안 나오나 했다	FALSE
정책 실패 비묭 수백 조 날리고도 모자라 개혁 도 없는 선거법 또 비례대표제 또 꼼수 적 폐가 무엇 이 넘 들 적폐 덩어리 서울대 생 들 투표 한 결과 가장 정의 롭 못 정당 위 민주당 압도 적 정의당 위 한국 당 대로 정의 당 나락 떨어지는 나라 순수한 학생 들 있어 그나마 안심 된다 수백 조 날리고 국론 분열 성공 없는 국정 수습 안보 인 이 걸 어떻게 처단 해야	FALSE
조현병 환자	FALSE
ㅋㅋㅋ 문 꼴통 이 무슨 개풀 뜯어 먹는 소리 참 이 삶은 소 대가리 같은 놈 X 가리 속 무엇 들어 있을까 똥 일까 된장 일까 뻔한것 아닌가 이 놈 너 천벌 내려 질 것 이 할 레루 아멘 나무 아미 관세음보살	FALSE
더불어 내 편 끼리 더불어 뭐라는거냐	FALSE
안하무인 문재인 안하 문재인	FALSE
라이 세상 물정 돌아가는 거도 모르고 지 혼자 구름 위 걷고있네 미친	FALSE
재인 졸라 흔드는거 좋아하네 맨날 흔들 수 없는 나라 만들겠다 이러면서 누가 보면 흔들 흔들 열매 흰 수염 빙의 하는줄	FALSE
그래서 갑자기 아베 빨았냐 죽창 죽 사발 됐네	FALSE
예수님 백년 전 한국 오셨다는건 금 시초 문이네요	TRUE
그걸 아는 사람 그래	FALSE
조직 적 링크 타고 좋아요 조작 중 보네요 아래 덧글 공개 되어있는 아뒤 들 아 링크 별 찬양 대단해요	FALSE
괴상한 정신 세계 주장 하는 문재인 말로 정신병 갑질 하는 늠 확실하다 아가리 쳐 닫고 북 꺼져라	FALSE
좋아요 조 작 질 ㅋㅋ ㅂㅅ 들 가지가지 한다	FALSE
도대체 크리스마스 운동 임시정부 왜 언급 하는 거 ㅋㅋㅋㅋㅋㅋㅋㅋㅋㅋㅋㅋㅋ 정치 적 사고 진짜 뿌리 깊나 보네	FALSE
입 다물어 이 사람	FALSE
원래 성탄절 그래 님 그리 말로 안해 ㅋ	FALSE
말 안되는 소리 질 그만하시지 쓰	FALSE
니 머 갈 통 깨고싶다 재앙	FALSE
북한 사랑 하는 마음 이겠지	TRUE
대통령 님 존경 지지 합니다 💙	TRUE
대통령 님 감사합니다 항상 응원 있어요 👍🏻	TRUE
건강하세요 지지 합니다 사랑 합니다	TRUE
예수님 죽음 탄생 행적 그리고 마지막 예견 되어 있었던건데 ㅋㅋ 그리고 돌 맞아 죽은건 스데반 집사 ㅎ 뭐 잘 알지도 못 하면서 말 그랭	FALSE
니 네 엄마 아들 싸 물어 야할듯	FALSE
사탄 우두머리	FALSE
문재인 세례명 디모테오 입니다 아는 척 하 쫄리쥬 ㅋㅋ	FALSE
교황 말씀 꼬인듯	FALSE
교황 양반 하느님 어떻게 생겼는지 아냐 목소리 하느님 한번 본적 있냐 쓰레기 사기꾼 인류 향 사 기질 좀 그만해라	FALSE
성당 교회 절 사찰 속 하지 마라 잘난 너 사탄 마귀 죽음 길 들어 가게 하는 집단 그 끝 죽음 뿐 없기 때문 메시아 장 절 나이 들 누구 외로움 질병 늙음 죽음 벗어날수 없고 벗어나려면 젊 어서 건강 지키며 살 가야 합니다 세 숫 대야 따뜻한 물 받아 앉아만 계십시오 좌욕 건강 지킬수 있습니다 오전 오후 이상 매일 실행 하십시오 젊 어서 代 건강 지키며 살아야 질병 고통 죽음 불행 벗어나 살 갈수 있게 되는 것 입니다 .http://blog.daum.net/mbbbk	FALSE
제발 우리나라 와서 더러운 개독교 들 점 데려 가세 제발	FALSE
단독 극우 보수 재벌 삼성 방송국 동아일보 채널에이 가족 자녀 친척 삼성 비리 부패 취재 보도 검색 해보세요 극우 보수 재벌 들 소유 지배 하는 언론 기사 네이버 점령 함 불법 만든 극우 보수 언론 종편 황금 채널 특혜 폐지 해야 합니다	FALSE
인간 누구 죽는다 살어있을 때 사랑 베풀고 살자 어러 웃 이웃 보살피는 세상 기부 하는 세상 대었으면 하네요 메리 크리스마스	FALSE
어이구 ㅜ 그랴 전광훈 목사 같은 사람 좋아하시나 봐요 종교인 무슨 정치 판 끼어들어서 이래라 저래라 하라 소리 앉았냐 아 정교 일치 나라 가시 그래요	FALSE
김수환 추기경 님 독재 쓴소리 마다 하지 않았는데 지금 성직자 누구 잘 못 된 정국 침묵 있고 오히려 동조 하는 성직자 있으니 참 안 따갑네	FALSE
김 추기경 진짜 독재 쓴소리 한거고 황교안 독재 프레임 씌워서 정권 잡으려 꼼수 쓰는거고 구분 안되냐	FALSE
그건 인정	TRUE
나라 둘 나눈 정부 없었다 국민 생각 하는 긍정 적 정치 못 오기 정치 하며 네로 남불 정치 다	FALSE
반 목 원흉 뭉	FALSE
문재인 정권 잘 새겨 들어야겠다	TRUE
함경도 문재인 독재정치 전라 좌파 이를 지적 못 하는 한국 천주교 반성 해라	FALSE
당신 나서지 그 랫 어 민초 들 나서면 반 목 이 요 민주 천주교 같아요	FALSE
빨갱이 집단 정의구현사제단 처단 해	FALSE
알긴 아 네 문재인 천주교 신자	TRUE
추기경 님 존경 합니다 이 때 뭐 하시다가 이제	TRUE
문재인 이 적폐 청산 이름 하 먼저 시작 했고 더 공산주의 끌고가려 한다 북한 핵 한국 정복 하려 드는데 주체사상 조금 연구 해봐도 밥 나온다	FALSE
ㅋㅋㅋ 좌빨 소굴 천주교 대 빵 현 시국 반 목하 말지어다 하고 위엄 떨면 뭔가 있어 보일까 ㅋㅋ 현 정권 개기지 말지어다 란 소리 더 됨 어디 저 분 과거 민주화 운동 경력 한번 구글 캐 볼까 나	FALSE
드디어 크리스마스 끝났다 아싸	TRUE
늘 좋은 말씀 감사합니다	TRUE
신동욱 씨 뉴스만 시청 한지 오래됬습니다	FALSE
예수님 믿으세요	TRUE
ㅎㅎ 손석희 보고 종 좌파 욕 하는 놈 들 야 조선 티비 더하던데 말 하면 뭐 어쩌라고 어버버 버 하고 말끝 내버림	FALSE
톰 후퍼 캣츠 감독 특히 에 촛불 든 수만 명의 시민 들 레미제라블 의 민중 노래 부르는 장면 정말 감동 적 이었습니다 영국 뿐 아니라 전세계 많이 봤고 저 굉장히 자랑스러웠습니다	TRUE
문재인 한 마리 덕분 미세먼지 가득한 그레이 크리스마스 보내게 됐네요	FALSE
나 행복 니 탄핵 당 빵 는것이다	FALSE
문 평화 문 평화 외치면서 홍콩 중국 내정 ㅋㅋㅋㅋㅋㅋㅋㅋㅋㅋㅋㅋ 빨 간편 들고 중국 몽 dreams come true	FALSE
잿빛 메리크리스마스	FALSE
덕분 물가 비싸져서 뭐 먹기 힘들다	FALSE
삐애 애액	FALSE
이 새끼 뭐 있으면 기어 쳐 나감	FALSE
예의 주시 개뿔 눈치 보것지	FALSE
광화문 성탄 연합 예배 참석 하기 위해 경남 가는 중 입니다 성탄 기쁨 자유 대한민국 뿐 아니라 북한 충만 하기를	TRUE
ㅎㅎㅎㅎㅎ 하나님 돈 좋와 해 난 좋은 사람 사랑 해 유대인 땅 위해 사람 학살 해 하나님 없어 만물 사랑 하는 사람 모두 하나님	FALSE
깨끗한 척 하시 기는 카톨릭 이미 마틴 루터 시절 끝났다	FALSE
요즘 사이비종교 단체 비교 되네 그러니 사이비	FALSE
따뜻한 사랑 실천 박수 보냅니다	TRUE
사기꾼 들 다 모였군요	FALSE
그럼 빨갱이 그냥 항복 하란 말 종교 문제 많어 없애라	FALSE
기독교 불교 못 믿게 하는 나라 북한 ㅋㅋㅋㅋㅋㅋㅋㅋㅋㅋㅋㅋㅋㅋㅋㅋㅋㅋㅋ	FALSE
제발 나라 망하게 하는 꼴 보고 있지 말라	FALSE
신수 훤합네 대한민국 이 꼴 될 때 뭐 하고 들 계셨우 밥 편하게 먹으려고 그 자리 있다면 내 려 들 오시우 지금 한 번 모든 것 내 탓 입네다 한 적이있우 밥 이 아 깝 습 네 ㅎㅎ	FALSE
형 동생 싸우고 있으면 관심 없는 부모 하는 가장 편한 말 니 들 싸우지마 서로 사과 해 이 것임 무책임 전형 임 뭐 문 젠 왜 싸우는 건지 어떻게 해결 해야 될 건지 누가 잘 못 했는지 상대편 대응 잘 못 된게 없는지하나 하나 살펴보고 이야기 해줘야지 싸우지마 이건 정말 무책임한 말임 이 시끄러운 와중 한발 빼고 멀리 고고 한 척 싸우지마	FALSE
빤스 목사	FALSE
윤보 환 이자 빨갱이 아닌가	FALSE
대한민국 적 화 되면 모든 종교인 수 용소 지하 교회 숨어야하는데 종교 지도자 사람 들 적 화의 위험 모르는거냐 알면서 침묵 하는거냐	FALSE
문재인 이 제발 그만 물러나라고 한번 해보 슈 들 모든 원인 국 헌 부정 하 저 자 부터 나오는 문제 임 안 지 혼자 독야청청 그럴거면 지 친구 노씨 왜 자살 했나 파 헤쳐 야할거 아냐 희안한 사람 임 죽으나 사나 세월호 선동 질 왜 십년 후 해도 늦지 않을 군자 복수 안 있는지 그게 젤 궁금함	FALSE
지 들의 성탄절 교회 예수 탄생 연극 보고 하하 웃고 떠들고 캐롤 부르고 맛 거 먹고 찬송 부르고 교회 밤새고 게임 목사 전도사 손잡고 예수님 고통 나누자 애기 그날 최고 만찬 장 진작 세계 고통 세계 거들 떠 보지 않음 하는 짓은 물티슈 교회 전 단 용 나눠주면서 예수님 당신 사랑 한다고 과연 그럴까 니 들 사람 사랑 하지 않으면서 예수님 맡기고 있고 윤보 환 씨 온실 자란 띠 내면 인터넷 지면 선상 얼굴 디리 밀면 나오면 큰 값 다 고 착각 하지 마시라	FALSE
평화 사랑 하는 성직자 분 들 마음 충분히 이해 합니다 하지만 싸울 때 싸워 야합니다 사회 질서 사람 들 자유 탄압 하는 것 들 우리 평화 원한다 하더라도 칼 들이 댈 것 입니다	FALSE
천주교 정의구현사제단 해체 하	FALSE
더불어 공산당 오랜 만 정권 잡으니 망나니 나라 온통 어지럽히고 혼란 만드 니미럴 ㄷㄷ	FALSE
개독교 문제 아닌가	FALSE
뭐 한국 기독교 총 연합 회 회장 전광훈 폭력 주의자 극단 주의자 더 ㅋㅋㅋ 윤보 환 한국 기독교 교회 협의 회 회장 님 전광훈 한기총 회장 하나님 나라 망한다 나면서 계시 내리는 소리 들리던가요 전광훈 들었다던데	FALSE
싸울 땐 싸워야지 한심한 종교인 놈 들	FALSE
앞 한국 가야 할길은 아프리카 사하라 사막 기근 하다 말라 죽은 나무 짐승 들 보다 못 객사 해야 할것 같네요 이 곳 저 곳 밥 그릇 싸움 싫 컷 처 먹 고 배 터져 죽어 봐야 안 싸울것 같네요	FALSE
대다수 종교 들 다른 종교 씨 말리는게 목표 싸우지 말 말 되냐	FALSE
에는 이제 싸우지 말 소리 종교인 들 주장 그렇다는 거고 사회 악마 들 한 테 자비 베풀어서는 안되는거다 사탄 싸움 좋아하는데 싸움 좋아하는데 싸움 말린다고 싸움 멈추겠냐 법치 주의 제대로 박혀있지 않은 이 사회 뇌물 쳐 받아 범죄자 들 공범 짓 하고 다니는 공무원 들 다 꼴 보기 싫음	FALSE
빨갱이 들 스스로 자폭 감방 가는데 이제 서 싸우지 말 하는 종교 ㅋㅋ 하는 짓 종자 들 같은거 아닌가요 온갖 선전 선동 깽판 다치고 빼앗아 놓고는 상대방 한 테 하지말라 ㅋㅋ	FALSE
빤스 목사 이 넘이 진정한 신 대한민국 호 예수 빤스 목사 추천 합니다 글로벌 하게 전 세계 뻗어 나가셔서 많은 이 들 구 원 하소 빤 쓰 목사 짱 비례 기독교 조만간 나온다고 하니 기대 되네요	FALSE
우리 사회 갈등 분열 정답 임 교회 앞장서서 함	FALSE
정신 들 차려 빨갱이 세상 되면 제 일 먼저 종교인 처리 된다	FALSE
종교 썩었다 정은 같이 광신도 들 키우고 있으니 너 할 것 믿사옵니다 로 만들고	FALSE
사랑 평화 구주 예수 탄생 축하 노래 성탄 명절 원수 이웃 내 몸 같 사랑 사랑 고린도전서 장 아니 읽 면서 기독교인 말 마	FALSE
천주교 불교 기독교 빨개이 들 주체 교 개종 했나	FALSE
그 놈 북한 평화통일 얘기 꺼내지 마라 오히려 장경동 목사 하는 말 훨씬 와 닿으니까 적은 자비 없이 죽여야 된다고 이스라엘 얘 들 이슬람 놈 들 왜 가차 없이 학살 하는지 좀 보고 배워라	FALSE
성탄절 맞이 하여 우리나라 평화 찾아왔으면 좋겠습니다 비단 기독교 뿐 아니라 다른 종교 단체 화합 평화 공존 위해 한마음 한 뜻 평화 위해 마음 모아 기도 드렸다고 하니 참 뿌듯합니다 이런 기사 자주 있었으면 좋겠습니다	TRUE
뼈 때리는 팩트 정치 관여 개독 우파 개독교 태극기 집회 등 적극 정치 관여 중 세금 우파 개독교 제일 강성 하게 뻐기면서 종교 탄압 이 라며 종교 계 세금 대해 뻐팅기 정치권 입김 불 있음 ㅂ ㅂ ㅂ ㄱ 개독교 우파 욕 안 마음 안든다고 나머지 종교 다 싸잡아 욕 하는 네 일베 댓글 러 수듄 ㅂ ㅂ ㅂ ㄱ 팩트 ㅂ ㅂ ㅂ ㄱ 팩트	FALSE
이미 종교인 들 싸우자고 하는데 그 사람 관리 하시지 들 그리고 세금 좀내고	FALSE
ㅋㅋㅋ 싸우지말고 민주당 숙여 들어가고 사회주의 만들자는 이야기 잖아 ㅋㅋㅋ 사기꾼 종교 쟁이 들	FALSE
니 들 할말은 아니지 특히 성 공 괴 대 먼가 ㅋㅋㅋㅋㅋㅋㅋㅋㅋ	FALSE
염수정 원 행 스님 관상 괜찮네 자고로 관상 눈 눈 탐욕 절으 안된다 그 절음 가장 가까운 눈 찢어진 눈 동시 아래 휘 어진 눈 새겨 들어	FALSE
종교 나약한 사람 들 믿는거 아니냐	FALSE
전광훈 이 사시미 들고 님들 목 따러 댕 기실듯 조심하세요	FALSE
온갖 사기꾼 들 판 있습니다 사기꾼 넘어가면 안됩니다 조심하십시오 부동산 사기꾼 투자 사기꾼 연애 사기꾼 정치 사기꾼 종교 사기꾼 재벌 사기꾼 방송 사기꾼 등등 절대 현혹 되지 마소 메리 크리스 마스	FALSE
전광훈 같은 타락한 목사 들 하나님 진노 임 하기 전 하루속히 회개 하시기 바랍니다 종교 정치 적 사안 목소리 낼 수 있겠으나 그 무기 증오 저 주 여서 안됩니다 대통령 목 떼 낸다 총 맞아 죽 것 등등 과연 예수님 시 라면 그런 말씀 하셨을까요 사탄 뱀 소리 없이 눈치 채지 못 하게 다가옵니다 정의 마음 시작 했으나 증오 분노 교만 내 마음 지배 있다면 그 정의 이미 악 변질 것 것 아셔야 합니다	FALSE
종교 지도자 또 뭔 신조어 개뿔	FALSE
제 나이 오래 어려운 이웃 위해 좋은 일 해주신 할머니 감사합니다 그 마음 본받아 어려운 이웃 들 돕겠습니다 존경 합니다	TRUE
이런 선심 쓰는듯 한 시상 계 열사 직원 들 고통스러워 하는 현실 돌아봐 줬으면 좋겠음 최근 U 관련 내부고발자 꼬리 자르기로 쫓아낸다 더	FALSE
LG 옛날 이렇게 의 챙겨서 상도 주고 지원 해주는 그룹 생각 했는데 오히려 업계 내 부적 사건 터지고 불합리 갑질 터지는거 보면서 이런 마케팅 그저 보여주기 식 마케팅 생각 안 듦	FALSE
너무나도 따뜻한 마음 여기 느껴지네요 항상 이런 마음 가지시고 선한 능력 나누시는 분 들 감사합니다	TRUE
광주 대 인시 장 천원 식당 있는데 어머니 대를 이어 딸 서민 들 정성 밥 해 주던데	FALSE
울지마 톤즈 영화 한번 보세요 고개 저절로 숙여지는 정말 존경 이태석 신부 님 이십 니 하늘 평안하시길	TRUE
올해 한국 유학 온 수단 분 명 의사 되지 않았나요 이태석 신부 님 고귀한 뜻 망각 되지 않고 이런 좋은 소식 많아졌으면 좋겠네요	TRUE
전 목사 같은 쓰레기 비교 되네	FALSE
정말 훌룡 하시고 감탄사 절로 나옵니다 예수 그리스도 할머니 축복 하시길 바랍나다	TRUE
할머니 존경 합니다 인간 사랑 하는 마음 없이는 절대 불가능한 일이 네 감사합니다	TRUE
이런 분 들 있기에 정말 훈훈한 세상 같습니다 존경 스럽습니다 할머니 오래오래 건강하셨으면 합니다 하루하루 조금 나태한 그리고 좀더 이 기적 생각 가지는 제 자신 부끄럽습니다	TRUE
이태석 신부 님 정말 존경 합니다 사랑 합니다	TRUE
벌써 됐구나 천국 잘 계시죠 신부 님 보고싶습니다 우리 교회 나라 위해 기도 해주세요	TRUE
울지마 톤즈 보며 많이 울 엇 던 기억 나네요 신부 님 그립네요	TRUE
개독 목사 서울 강남 드글드글 이유 제일 돈 많잖아	FALSE
너무 돈 밝히는 목사 주지 가 판치는 세상 한 줄기 빛 보여주시고	TRUE
교인 아니지만 신부 님 삶 참 아름답습니다	TRUE
참 맑아 보이십니다 너무 빨리 가셨네요	TRUE
정말 이런 사람 또 없습니다 ♥	TRUE
이태석 신부 님 정말 정말 존경 사랑 합니다 찬미 예수	TRUE
내 가장 존경 하는 분 천국 편히 쉬 계시	TRUE
이태석 신부 님 존경 합니다	TRUE
모든 종교인 들 아니 세계 모든 사람 들 이분 마음 이면 그 곳 천국 겠죠	TRUE
노벨 평화상 추천 해도 될 듯 싶은데 한국인 가슴 속 영원히 성자 기억 될 겁니다 톤즈 요	TRUE
묵상 아무 것 모를 때 그냥 노래였는데 요즘 전주 들어도 신부 님 생각 눈물 납니다 끝 부를수가 없어요	TRUE
거기 선 아프지 않고 잘 계시	TRUE
천민 자본주의 물든 미국 한국 근본 주의 개신교 본받아야하는데 영국 개신교 변질 되서 미국 건너와서 자본주의 물들고 한국 서는 돈 신 숭배 하는 지경 이르렀으 한국 개신교 보면 무당 더하다 푸닥거리 돈 신 숭배 있더라 개신교 목사 전체 천주교 신부 님 하나 안되네	FALSE
존경 합니다	TRUE
신부 님 보고싶어요 존경 합니다	TRUE
이태석 신부 님 존경 합니다 사랑 합니다 축복 합니다	TRUE
닮기를 기 도합 니 순종 하게하소서	TRUE
신부 님 사제 되어 톤즈 의료 및 교육 선교 헌신 하신건 신부 님 입장 결코 마이너스 아니엇습니 만일 의사 길 갓으 어땟을까 의사 사는것도 골치 아픕니다 정기 적 연수 참가 그렇구 나날이 발전 하는 시대 처방전 의료 기술 시설 그 맞게 업대 이 트 하지 않으면 손님 줄어드는게 현실 이구 글구 병원 의료사 나면 일이 커집니다 물론 대형 병원 배 째 한다는데 그래도 사람 들 한번 그런 사고 나면 한동안 내 원 안 하기 땜 타격 크고요 대학병원 환자 못 고치는 일 들 흔해져서 의사 신뢰 도 낮은게 사실 임다	TRUE
■ 하루빨리 위선 적 문재인 정권 무너지 기를 매 일 매일 기 도합 니 ■	FALSE
존경 합니다	TRUE
할머니 LG 도 감사합니다	TRUE
저 도 꾸벅 🙂	TRUE
문재인 이오 사데기 때리시구여 ㅋㅋ	FALSE
이런 분 의인 경실련 김지은 의인 상 풉 상 격 떨어지게	FALSE
오래오래 건강하게사 시기 바랍니다	TRUE
다른 모든 완벽하니 이제 폰 잘 만들자 ㅎㅎ	TRUE
응 조만간 중국 기술 다 털리고 없어질거야	FALSE
대단하십니다 할머님 늘 건강하시고 하늘 복 자손 대대로 축복 받으시길 기도 드립니다	TRUE
대접 받아 야할 나이 도리어 남 돕고 대접 하며 사는 삶 건강 장수 비결 된 듯 합니다 복 받으시길 바랍니다	TRUE
역시 LG 네요 독립 후손 답 사업 더 잘 되어서 더 많은 사람 도 울수 있는 기업 되었으면 합니다	TRUE
감사합니다 당신 같은 분 덕분 이 겨울 마음 따뜻해 집니다 항상 건강하세요	TRUE
훈훈한 기사 오랜 만이 네 할머님 오래 사십 시오	TRUE
참으로 훌륭하십니다 늘 건강하세요	TRUE
정말 대단하십니다	TRUE
진정 이웃 사랑 봉사 하신 분이네요 정말 훌륭하십니다	TRUE
존경 스럽네요	TRUE
이런 상 만들고 곳곳 이런 분 들 계셔서 살 만 세상 느낍니다	TRUE
LG 복지 재단 찌 간 진지 층 입니다 아 재 몰라서 그러는대 신조어	FALSE
째 무료 급식 소 봉사 하시다니 정말 대단하시고 존경 합니다 오래오래 행복하시길 바라겠습니다 LG 이런 분 의인 상 주는 모습 보기 정말 좋아요	TRUE
째 무료 급식 소 봉사 하신다는 건 정말 어려운 일 할머니 존경 합니다 오래 오래 건강하게 사시길 바랍니다 그리고 의인 상 주는 LG 그룹 좋은 그룹 요	TRUE
이 시 대의 의인 이십 니 아름다운 영혼 갖은 할머니 평화 빕니다 감사합니다	TRUE
항상 건강하셔서 좋은 일 많이 하시기 바랍니다	TRUE
정말 훌륭하 신분 입니다우리 사회 정 할머님 같은 분 들 많아지길 바랍니다	TRUE
삼 성 의인 상 이 잇다면 이재용 가족 줄거 같다	FALSE
LG 만 사고 씁니다	TRUE
잘 하고 있습니다 관련 된 모든 분들 고맙습니다	TRUE
건강하십시오	TRUE
기자 이쁘네	TRUE
할머님 존경 합니다 건강하게 오래오래 사세요	TRUE
사랑 합니다 할머니	TRUE
세 연세 다른 목적 없이 꾸준히 순수한 봉사 하시는 할머니 매우 존경 스럽습니다 Lg 도 좋은 분 상 주셔서 멋지네요	TRUE
Lg 는 좋은 일 많이 하네	TRUE
폰 빼고 쵝오 ♡♡	TRUE
L zkzh ㅋㅋㅋ 반박 할 수 없는 LG ㅠㅠ 최근 불거진 그 세탁기 건조기 그것 포함 해서 빼고 최고	TRUE
삼성 장학재단 있어 글구 맹인안내견 훈련사 업도 있다	TRUE
정말 훌륭하십니다 오래 건강하세 요나 도봉 사하는 맘 갖고 살아야겠다 존경 스럽네요	TRUE
천주교도 엘지 멋찌	TRUE
의인 상 기준 이렇게 다르네 시민단체 안희정 비서 주던데 ㅋ 할머니 건강하세요	TRUE
어르신 건강 하세요	TRUE
정 할머님 건강하십시오 LG 도 칭찬 합니다	TRUE
존경 합니다	TRUE
할매 최고	TRUE
참여연대 보고있나 이런 분 바로 의인	TRUE
젊은 사람 부끄럽네요 연로 하신 할머니 서도 봉사 하시면 베푸시며 사시는데 다 같은 어려운 이웃 보듬고 따뜻한 사람 되었으면 합니다	TRUE
어르신 축하 드리며 건강하세요	TRUE
을 오로지 남 위해 살아오셨네요 정말 존경 스럽습니다	TRUE
박수 보냅니다	TRUE
정말 멋지세요 할머님 좋은 일만 가득하세요 😄	TRUE
가전 LG	TRUE
할머니 만수무강 하시고 복 받으실 겁니다 아멘 육 억 불 올림	TRUE
학교 영어 교과서 본문 배워서 알 된 분이셨는데 톤즈 위해 타지 헌신 이태석 신부 용기 선함을 본받고 싶어요 감사합니다	TRUE
울지마 톤즈 보고 내 가보 ㅈ 내내 울었던 기억 나네요 숭고한 사랑 희생 이 못 저 의 가슴 먹 먹하게 했습니다	TRUE
진정한 천사	TRUE
이 신부 님 같은이가 진짜 예수님 따르는 사람 전 ㅇㅇ 목사 창피하다	TRUE
신부 님 오래 기억 할께요	TRUE
좀 더 우리 같이 이 세상 더 좋은 많은 일 들 하시다가 가셔도 늦지 않은 데 너무 일찍	TRUE
착한 개독 뭐	FALSE
별 다 문화재 무슨 도 안된 걸	TRUE
문화재 무슨 정의구현사제단 반정부 단체 산실	FALSE
감사합니다 어려운 환경 늘 그 들 함께 나눔 실천 하는 고인 모습 그립네요	TRUE
퍼주 나눔 아니라 삶 나누는 나눔 ᆢ 너무 감동 적 말 이	TRUE
신부 님 천상 낙원 영원한 안식 누리 시기 기도 하겠습니다	TRUE
이태석 신부 삶 이끈 힘 예수 그리스도 외 설명 할 길이 없습니다 이 글 읽는 모든 분 들 예수님 영접 하시길 축복 합니다	TRUE
세상 이렇게 사랑 베푼 신부 님 고맙습니다 조금 본받으려고 하겠습니다	TRUE
인간 아니였던 분 입니다 예수 다른 모습 오 신분	TRUE
종교인 아니지만 예수님 잠깐 오셨다 간것은 아닐까 요 본인 많은 번뇌 하셨겠지만 한국인 이라는게 감사하고 존경 스럽고하네요	TRUE
가난하고 약한 자로 오신 예수님 이 땅 예수님 닮은 제자 삶 사신 분 그 어려운 길 가신 신부 님 존경 합니다 크리스찬 더 사랑 나누고 낮아지고 겸손해지려 노력 하겠습니다	TRUE
아름다운 호탕 한 웃음 그립습니다	TRUE
가장 숭고하고 아름다운 생 살아가 신분 존경 또 존경 합니다	TRUE
세상 다시 없으실 분이십니다	TRUE
정의 구현 사 제단 침묵 의미	TRUE
이 신부 님 생각 하면 기 슴 울림 일어남니다 일찍 가신 이유 있을 겁니다	TRUE
아니 왜 이런 분 일찍 돌아가시는거지	TRUE
하늘 봉사 하시고 계시겠군요 존경 합니다	TRUE
밀알 헌 알 땅 떨어져 섞어야 열매 맺는 다는 증거 겨자 나무 더 크게 신부 님 나라 커져 가기	TRUE
필요 사랑 알 보는 말 그대로 삶 나눔이었군요 이제 그 열매 맺어 가나 봅니다 이태석 신부 님 큰 사랑 고개 숙여 집니다 오래오래 기억 되길 바랍니다	TRUE
신부 님 감사합니다	TRUE
늘 기억 하겠습니다	TRUE
하늘 쓰려고 빨리 모셔가는듯	TRUE
가장 가난한 가장 낮은 곳 머물다 가신 신부 님 위해 기도 드립니다	TRUE
새 신부 님 들 그리고 가족 분들 지도 신부 님 모두 모두 수고 많으셨습니다 기쁨 은총 많이 많이 담아 갑니다 🙏🙆	TRUE
새 신부 님 들 진심 축하 드립니데이 ㅋㅋㅋ 😀💓💓🎊🎉	TRUE
새 신부 님 들 부제 님 들 축하 드립니다	TRUE
신부 님 사랑 합니다	TRUE
과연 신부 님 반기실지	TRUE
울지마 톤즈 정말 감명 깊게 본 입장 이런 걸 보면 한국 정말 머릿속 속물 근성 없는 나라 같다 이태석 신부 정녕 자신 사후 을 들여서 생가 복원 시키고 카페 기념관 짓는걸 바라셨을까 다큐 제대로 봤다면 이런 우상화 비 스무 리 짓은 벌리지 않았을텐데	TRUE
평생 남 위해 기도 봉사 하신 신부 님 천 국가 더 행복하게 살아가길 빕니다 항상 신부 님 생각 기도 하겠습니다 행복하세요	TRUE
가을 가장 잘 어울리는 곳 것 같습니다 불과 몇 년전 해도 경기도 광주 교통 편이 안 좋았는데 지하철 경 강선 경기도 광주 거치면서 교통 편이 정말 많이 좋아진 것 같습니다	TRUE
고유 정도 추가 되길 기원 합니다	TRUE
연쇄 살인마 들 인간 악귀 들 이기 때문 처형 시켜 야한다	FALSE
그렇게 인권 중시 하는 정부 탈북자 두 명 죽으라고 돌려 보냈다지요 김정은 삐질까봐	FALSE
아무리 후레말종 인간 죽음 앞두고 한번 반성 한다고 했다 어차피 집행 되지도 않을 사형 거 저 들 더 잘안다 무슨 반성 하겠나 국민 세금 내서 먹여주고 재워주는거지 얼마 전 생활고 땜 서울 한 복판 아사 모자 있었지 당장 가난 끼니 걱정 하는 사람 들 과연 저런 사형수 들 나은 삶 산다 누가 말 할수있나	FALSE
명 국민 세금 먹이 재우는건 뭐 생명 빼앗은 놈 들 본인 들 생명 빼앗겨야 맞다	FALSE
집행 해라 이거야 말로 국민 명령 공지영 반대 하겠지만	FALSE
준표 형 형 뿐 없다	TRUE
유족 들 집행 맞기면 좋을거 같아요	FALSE
오래 살 아보 사람 쉽게 안 변하더라 더구나 처음 어렵지 사람 죽여 본 사람 점점 더 사람 쉽게 아니 더 발전 해서 죽이더라 전 세계 그리고 종교 계 반대 하겠지만 집행 하는게 맞다 그 래야 살인 할까 말까 고민 하다가 누군가 살아남지 않을까 사형 미집 행 이후 웬만한 사건 저지르고 안 잡힐려고 다 죽이더라 이건 아니라고 본다	FALSE
집행 좀 해	FALSE
사형 찬성 강호순 사형	FALSE
국민 세금 아깝다 빨리 집행 해라	FALSE
이참 미뤄놨던것 들이랑 싹 집행 해 버리지	FALSE
반드시 사형 제도 필요합니다 선 고만하지말고 집행 해야 합니다	FALSE
사형 시키지를 않을꺼면서 사형 왜 주는지 차라리 무기징역 주지 말 사형 무기징역 똑같은 거 법 머 사람 명 죽였는데도	FALSE
무기징역 이상 모 범수 살 나오는 형법 입니다	FALSE
사형수 들 대한 조속 형 집행 촉구 한다 피해자 들 한을 풀어야 한다 형 집행 어려우면 피해자 가족 들 대집행 허용 하 눈 눈 김대중 위선 자 들이 설쳐 형 집행 안되고 있다 하나 알 열은 모르는 위선 자 들 때문 반드시 형 집행 하여 죄 짓고는 못 산다는 확신 줘 야한다	FALSE
사형 존폐 론 관 학사 논문 제출 했었다 당시 정치인 사상 범 대한 사형 자행 되던 독재정 권 시절 사형제 존치 폐지 쪽 입장 논문 제출 했던 기억 난다 연쇄 살인마 같은 인간 이기 포기 흉악 범 사형제 예외 적 허용 되는 게 맞겠다 지금 사형 집행 선량한 국민 지키는 길이 교도 질서 바로잡는 계기 될 것	FALSE
국민 목소리 사형 집행 하 대체 뭣 들하고 있는가 할 일 하라	FALSE
사형수 들어가는 세금 젤 아깝다 날 잡아 한 날 다 위로 보내라	FALSE
집행 하지 않는 사형 집행 해야죠 나머지 명도	FALSE
다음 대선 사형제 이슈 해서 집행 찬성 하는 후보 뽑는게 시급하다	FALSE
사형 집행 해 솜방망이 처벌 또다른 불씨 른 만든다	FALSE
무기 지역 사형수 이참 장기 증 다시키 매달 자	FALSE
아직도 내 세금 살인마 들 숙식 지출 되고 있다니 화난다	FALSE
문재인 포함 하면 명 입니다	TRUE
사형 집행 하자	FALSE
인권위 종교 각종 시민단체 들 의견 존중 국민 들 말 말 같지 않냐 지 들 가족 들 죽어 봐야 정신차리려나 유영철 오원춘 이 빵 간 의형제 맺고 호위 호식 하 아직도 국민 들 세금 축 낸다지	FALSE
개 단체 가족 들 연쇄 살인마 끔찍한 고통 당하거나 본인 당한다면 과연 사형 폐지 주장 할수있을까 모든 상황 상대 적 다 종교 적 이기심 인권 맹목 적 신념 때문 오늘 명의 살인마 들 국민 혈 새로 꽁 보리밥 먹으며 살찌면서 잘살고있다 그게 합당 한 처사 묻고싶다	FALSE
사형 못 하면 매일 숟가락 이빨 때려라	FALSE
사형 부활	FALSE
언능 확정 명 한 방 사형 집행 시켰으면 좋겠습니다	FALSE
쓰레기 들 아직도 살려 두냐 밥 먹구 똥 싸는 쓰레기 들	FALSE
쓰레기 아깝습니다	FALSE
집행 서에 결제 하지 않은 법무 장관 들 전원 직무 유기 감방 보내야 한다	FALSE
감옥 요즘 난방 되고 시설 좋다든 데 사람 죽인 것 들 국민 세금 처 먹여 살리는게 과연 맞는건 인지 모르겠네 못 먹고 못 살 빚 더미 목숨 끊는 사람 들 있는데	FALSE
윤씨 시절 cctv 등 과학 적 증명 안 됐고 고문 범인 만들었지만 지금 다르지 않는가 확실한 증거 객관 증거 등 확실함 사형 시켜야 된다고 본다	FALSE
데이비드 게일 영화 보고 와라 선진국 들 사형 안 하는 이유 있다	TRUE
사형 안 시키고 밥 먹이 재워주고 세상 편하네 죽 개밥 줘라 묻을것도 없다 걍 개 먹여 개 못 헌것 들	FALSE
사형수 명 들어가는 치 돈 얼마 줄 아느냐 세금 살려 두는 행위 싫고 잔혹 범죄 저질르고 살 숨쉬는건 더욱더 싫다	FALSE
어차피 집행 안 하잖아 무늬 사형 실질 적 무기징역 거지 세금 밥 먹이 의식주 제공 아깝다 사형 부활 시켜라 미국 사형제 시행 중이 선진국 다 사형 폐지 거 아니다	FALSE
종교 인권 시민단체 니 들 가족 중 한 명 꼭 안 득 강호순 유영철 같은 살인마 아무 이유 없이 잔인하게 살해 되길 바 그리고 그 살인 범 무기 감형 되서 모범 수로 가석방 되를 더 더욱 바	FALSE
사형 집행 안 하는 쟤 들 평생 먹여 살릴 밥값 재산 압류 해라 세금 아깝다	FALSE
사형제 부활 시켜라 조선 죽 인간 씨 레기 많음	FALSE
사형 집행 하라	FALSE
제발 제발 모 범수 이런 제도 없에	FALSE
인권 사람 적용 되는 권리 아무리 봐도 너무 편하게 먹여주고 재워주는거 같음 집행 안되니까 죽음 대한 심 적 공포 고통 않느 낄거 같음 죄 가장 명확한 인간 한 명 본보기 집행 하면 좀 더 깨끗한 사회 될거 같음	FALSE
사형 집행 하 있는 거	FALSE
가족 들 마지막 직 별 인사 시키고 이제 그만 집행 해라 평생 갇혀 있으면 세금 아깝고 있는 가족 들 힘들다 그리고 본인 도 희망고문 국민 들 가족 본인 위해 그냥 집행 해라	FALSE
집행 좀 해	FALSE
고마 쉐리 사형 시키 삐라 북한주민 인권 무시 하는 정부 저런 인간 들 인권 존중 하나	FALSE
고 유정 그 악마 년도 사형 시키자 꼭	FALSE
집행 해야 한다 지금 cctv 유전자 감식 등 명확하잖아 과학 적 증거 있는 경우 이론 여지 없는 경우 사형 집행 해야 한다	FALSE
사형 찬성	TRUE
집행 먼저	TRUE
저런 인간 이길 포기 금수 못 쓰레기 들 세금 쓰는거 너무 아깝다 집행 해라 대선 공략 있으면 투표 한다	FALSE
그 밑 쳐 들어가는 내 세금	FALSE
피의자 사람 이번 정부 정책 동떨어진 구형	FALSE
세금 또 낭비 그냥 집행 하지	FALSE
신부 님 그 곳 편안 계셔요 당신 엔젤 입니다	TRUE
이런 분 들 진정 이 시대 영웅 이 시	TRUE
위대한 인간 동시 대 살았다는게 영광 입니다	TRUE
북괴 찬양 시집 봐야 아깝다 북괴 올라갔으면 한 자리 했을텐데	FALSE
깔깔 깔 김씨 독재 한국 공격 할 기회 노리고있는 북괴 하나 거 사양 할께요 독재 타도 외치면서 진짜 독재 김일성 떠받 드는 말 안되는 운동 하는 사람 너무 많음	FALSE
무슨 논리 흉악 범 사형 하는거에 ㅡ 캐캐 묵은 정치 탄압 사변 등 반 대 논리 직설 하나	FALSE
그래도 사형 시킬 짐승 같은 것 들 사형 시키는게 맞다라고 판단 합니다	FALSE
법 명의 범죄자 처벌 하는것보다 명의 무고 시민 나오지 않게 하는것이다	FALSE
엄벌 주의 결단코 범죄 율 낮출수 없음 이 증명 됫습니 범죄 예방 할수 없어요 범죄 놀 예방 하는 유일한 방법 사 회안 전망 확충 빈민 율 줄여 야합니다	FALSE
그래서 아이 유괴 강간 살해 아무 면식 없는 사람 살인 인득 영철 같은 인간 세금 먹여 살리 자고 증거 확실한 인간 보는데서 갈기 찢어야 나라 잡히는데 사형 폐지 론 자 시청 앞 광장 공개 화형 해야 한다니깐	FALSE
폼 잡으려 하지마라 정치인 사형 권력 보전 이용 했다면 이 시 대의 자칭 인권 주의자 박애주의자 들 사형제 폐지 단순 당연히 주장 하는데 그 들 사회 안전하게 유지 발전 시켜야 하는 더 큰 명제 잊고 있다 더군다나 글 예 로 권력 유지 목적 희생 된 인간 정치가 없어져야 하는것이지 사형제 자체 문제 아니다	FALSE
교수 란 사람 공감 일도 안 가게 자기 생각 늘어놓고 있냐 독립운동가 흉악 범 짬뽕 시키질 않나 싸이코패스 같은 연쇄 살인마 들 지 몸 위해 되는 일 엄청 신경 쓴다는 연구 같은건 안예 보이지 않는 가벼	FALSE
윤봉길 의사 몇몇 사진 사형제 폐지 호소 하지마라 진짜 죽 싶은 사형수 많다	FALSE
판결 공정하다고 믿을 수 있어야 사형 가능한데 검찰 그리고 법관 믿을 수가 없다 사형 반대 하는 나 이유 대신 형 가석방 없는 무기징역 바꿀 필요 있다	FALSE
사형 집행 안함 해서 결과 적 이춘 재 자백 했고 그로 인해서 무 고함 밝혀졌죠 본질 정치 탄압 사형 쓰여졌다는게 아니라 인간 언제나 오 판 할수있기 때문 함부로 국가 권력 개인 목숨 빠았는일 없어 야한다는 것 이	FALSE
인류 사회 사형 패륜 적 흉악 범죄자 건강한 시민 들 로부터 영원히 격리 하는 수단 되었던 것 아니라 오히려 정치 적 반대 자 그 세력 효과 적 말살 하는 방책 악용 되어 왔습니다	FALSE
흉학범 사형 시키지 않고 국민 세금 형무소 죽 때 보살피는게 과연 타당 한지 심히 개탄 스럽습니다 개인 적 사형선고 받은 범죄자 사형 이 실행 되는 방향 법 강화 되어야 되고 또한 사형 집행 되어야 되겠습니다	FALSE
지금 정치 탄압 하는 시대 좀 사형 집행 해야 할 인간 말종 들 보 내주자구요	FALSE
집행 하지 않는 사형 무기징역 뭐 다른	FALSE
지금 우리 말 하는 사형수 정치범 말 하는 것 아니잖아	FALSE
사형 그저 또다른 살인 일 뿐 정당 화할 근거 전혀 없다는 것 동의 합니다 하지만 국민 들 법 감정 아직 사형 붙잡고 있는 건 범죄자 대한 형벌 너무 적다는 인식 비롯 되었다고 생각 합니다 사형 존폐 토론 할 때 형사 처벌 보다 강해져야 한다는 말 나오는 것 그 때문 이 고요 국회 일 좀 해서 형법 개정 하면 좋겠네요	TRUE
유신정권 시대 사형 당하신 명단 충격 적이네요 언제 상황 따라 악법 될 수 있다는 얘기 겠지요 ㅠㅠ	FALSE
우리나라 무슨 사형 중단 을 채워 얼마 전 북한 강제 북송 해서 간접 사형 시켰구만 ㅉㅉ 당신 기준 직접 죽여야만 사형	FALSE
아무리 언론통제 한다해 지금 같은 시대 사형제 부활 한다고 옛날 함부로 반대 세력 숙청 같은거 할수 있을거 같진 않은데 정 그게 걱정 된다면 사형수 신원 죄목 공개 처단 하면 되지 않는가 정치 적 이용 솜방망이 처벌 범죄자 들 법 자체 우습게 보는게 더 심각하다 본다	FALSE
확실한 놈 사형 답	TRUE
저런 글 쓴이 같은 마인드 가진 작자 들 때문 보신 주의 판사 들 늘어나고 우리나라 치안 중남미 국가 들 남아공 요하네스버그 망가져가는거다 이 더러운 군상 덩어리 필리핀 사형 폐지 인해 치안 얼마나 망가졌고 그로 인 상처 얼마나 큰줄 알고있냐	FALSE
그렇게 따지면 사법 시스템 자체 불가능합니다 인간 하는 일 는 없는데 다만 그 오류 최소 화 하려고하는거죠 제도 잘 못 된게 아니라 제도 악용 하는 사람 들 잘못 이	FALSE
좋은 글 입니다 고맙습니다	TRUE
내 관심 법 보았노라 솔직하게 말 하라	TRUE
진짜 사형 집행 한다 하더라도 흉악 범죄 많이 줄어들지는 않을 것 그러나 분명 인과응보 란 측면 필요하다고 본다 천 인공 노 할 범죄 저지르고도 교도소 편히 먹고 자고 이러한 현실 화가 치밀어 오른다 현 시점 사형 집행 불가능할거 같고 가석방 없는 종신형 제도 도입 시급하다고 봄 기꺼이 세금 낼 터	FALSE
사형제 폐지 주장 하는 이 들 주장 빠지지 않는 것 바로 오 판 가능성 입니다 물론 집행 사실 되돌리기 어렵다는 점 사형 제도 가장 여실히 드러내기야 합니다만 이는 사형제 도를 비롯 모든 형벌 동일하다는 점 간과 주장 입니다 이번 이춘 재 사건 같이 경찰 부실 수사 인해 이라는 세월 감옥 보내야한 또다른 피해자 시간 그 어떤 것 되돌리거나 보상 할 수 없습니다 오 판 가능성 여부 두고 사형제 폐지 하는 것 문제 아니고 수 사 과정 재판 과정 문제 발생 하지 않도록 철저한 개혁 우선 입니다	FALSE
사형 부활 하다	TRUE
돈 만큼 중요한 다른 가치 들 있다는걸 인정 받는 세상 되었으면 합니다	TRUE
적 대 행정관 기사도 좀 쓰지 돌아가 신분 얼마나 억울할까	FALSE
고개 들어 적 대를 보라 그 인권 타령 얼마나 이 기적 지 들 편리할 데 해석 되는 인권	FALSE
지금 우리나라 삼 성 빼 믄 남는게 없다 국가 AI 기술 개발 대책 마련 준비햬 후진국 놀이 그만하고	TRUE
삼성 영업 기밀 까발려주고 뒷돈 좀 챙기려 구애 쓴다 개 마이	FALSE
기자 양반 니 들 삼성 국가 기여 해보소	FALSE
기업 영업 비밀 필요한 규율 보장 해줘야지 않을까 지금 현실 감안 할 때 인권 변호사 게 불공정 근원 국가 좀 먹는 종북 좌빨 들 명함 같다	FALSE
사람 목숨 좀 아끼자는 기사 왜 이런 알바 붙는지 한심할 따름이네요	FALSE
👍👍👍👍👍👍👍	TRUE
아래 삼성 직원	TRUE
정말 웃기 이 대한민국 판단력 제로	FALSE
오마이 쓰레기	FALSE
정치 적 견해 달라 고인 명복 빕니다	TRUE
훌륭하신 댓글 입니다	TRUE
댓글 보고 너무 놀랐어요 잘하고 못 하고를 떠나서 슬픈 일 함께 공감 해주는 성숙한 시민 됩시다	TRUE
연로 하신 어머니 혼자 계시 했다고 욕 해 대는 사람 들 당신 들 부모님 나 잘 하시게 들 그리고 대통령 독자 아니고 형제 들 여럿 누가 모시 옆 모셨을건데 무슨 폐륜 취급 들 그리 욕 하 들 지금 당신 부모님 들 안부 전화 한번 씩 들 하소	TRUE
모친상 악플 다는 인간 적 기본 안된 보수 꼴통 일베 세 키 들 씨 말려 야할 유전자 들	FALSE
근데 왜 박근혜 대통령 는 박정희 죽은 날 탕탕 정이 놀리면서 탕수육 먹어 야한다고 조롱 하면서 낄낄대셨나요	TRUE
삼가 고인 명복 빕니다 아무리 악플 달 싶어도 아무리 욕 하고 싶어도 이런 기사 와서 악플 다는건 자신 뿐 아니라 가족 부모 욕먹이는 짓 입니다 자제 합시다	TRUE
문재인 대통령 님 김정숙 여사 님 나랏님 자리 그러한 것 생각 합니다 윗 물이 맑음 어찌 이리 아랫 물이 정화 안되는지 편안한 저녁 보내시고 내일 건강한 모습 뵐 것 기대하겠습니다 진심 애도 표 합니다	TRUE
전 우파 좌파 아니지만 정치 다른 문제 어무이 돌아가셔 눈물 흘리는 사람 헛소리 하지 말아야지 않나요	TRUE
어머니 위대하다 대통령 참 어려운 시기 끝 아들 챙기시네 사람 먼저 문재인 대통령 우리 같은 평범한 사람 인간미 느껴진다 대통령 님 국민 위해 힘내세요	TRUE
대통령 님 힘 내세 국민 들 어깨 내어 드리고 있습니다	TRUE
이글 문재인 탄핵 이야기 하는 사람 들 문재인 탄핵 이 닭 대가리 사형 참수형	FALSE
대통령 님 힘내세요	TRUE
모든 사람 어머니 있습니다 이 순간 공감 해주시고 배려 해주는게 도리 아닐까 요 그 간단한것을 모르다니	TRUE
대통령 이어도 어머니 어머니 시 요 마음 잘 추스르셨으 좋겠네요 삼가 고인 명복 빕니다	TRUE
저 싫어합니다 어머니 돌아가셨는데 욕 은하 마세요	FALSE
좋은데 가셨으니 너무 슬퍼 마세요 그나저나 북한 저 것 들 땜 쉬시지도 못 바로 서울 올라오셨다니 건강 해치실까 너무 걱정 됩니다	TRUE
짐승 못 악플러 들 말 한마디 천 빚 갚도 살인 면 한다 했다 슬픈 일 당한 분 힘 못 되어줄 망정 악플 다는것은 너무나도 사악한 짓 니 들 죽은 후 반드시 지옥 떨어질것이고 영원히 못 나올것이다	FALSE
대통령 좋든 싫든 부모님 가시는 길 눈물 흘리는 아들 모습 왈가 왈부 하 말 어머님 보내 드리는 중이 잖아	FALSE
댓글 실명 제 좀 합시다 정말 인간 이기 포기 댓글 넘 많네요	FALSE
댓글 창 닫는게 답 듯 보입니다	TRUE
홍문종 제 정신	FALSE
고인 명복 빕니다 문 대통령 님 조금 위로 힘 되는 댓글 되었으면 좋겠습니다	TRUE
삼가고인의 명복 빌며 아울러 대통령 님 응원 아픔 위로 드립니다	TRUE
삼가고인의 명복 빕니다 대통령 님 건강 잘 챙기세요	TRUE
부디 마음 추 스리 시 힘내시기 바랍니다 어머님 하늘 응원 해 주시리라 믿습니다	TRUE
문 대통령 님 강한 마음 버티세요 사세요 살아주세요 기 사 내용 어긋나서 죄송하지만 여기다가 쓸게요 잘 살아만 주세요	TRUE
hoot 님 니앙스 없는 말 이 대통령 님 그렇게 쉽게 무너지는 분 아닙니다 뭔가 선동 하는것 같군요 기 사 내용 도대체 뭡	TRUE
언젠가 부터 댓글 읽기가 무섭습니다 나라 인해 피해 정말 많이 보셨나 봐요 자신 모습 되 돌아 보신 적 있나요 누구 탓 할만큼 잘 살아왔는지 그래도 현 대통령 그 어머니 부음 입니다 더 나은 대한민국 위해 칭찬 채찍 모두 필요하다는 것 공감 하 수준 이하 댓글 눈쌀 찌푸리게 만듭니	TRUE
니 쇼쇼쇼	TRUE
네이버 댓글 쓰레기 비판 아니라 저 질 비난 밤 낮 죽 뭐 하는 건지 네이버 실명 제 꼭 필요하다 봅니다	TRUE
이런 절 홍어 시키	FALSE
대통령 님 힘내세요 끝 믿고 기도 하겠습니다	TRUE
삼가 고인 명복 빕니다	TRUE
어머님 삶속 울 대통령 모습 대한민국 미래 봅니다 믿고 희망 보 구 과거 의리 아닌 지도자 로서 강한 면모 기대합니다	TRUE
대통령 보여주신 장례 절차 우리 국민 본보기 것 같습니다 아직도 허례 허식 관혼상제 문화 이번 기회 통해 변화 하길 바랍니다 삼가 고인 명복 빕니다	TRUE
참 인간 적 면모 우리 그만 헐뜯고 그만 미워합시다	TRUE
삼가 고인 명복 빕니다	TRUE
어느 집 가족 들 아는 사연 있다 남 들 이해 받지 못 해도 가족 이기 보듬을 수 있는 일 들 있고 대통령 님 눈물 평생 가족 위해 헌신 하신 어머니 걸어온 시간 들 녹아있을 것 같아 더욱 가슴 먹 먹하다 ㅜㅜ	TRUE
맘 아프네요 휴식 없이 바로 복귀	TRUE
문재인 대통령 님 힘내시고 건강 잘 챙기시고 국정 업무 보십시요	TRUE
밥 먹고 다니냐 무식한 니 한글 깨우치느라 애썼다 이제 한글 진실 알도록 노력 하 거 그런데 천주교 알고나 있니	FALSE
ㅠㅠ 하늘나라 평안하세요 ㅠㅠ	TRUE
여기 댓글 보니 부모 모르고 도리도 모르는 썅 노무 OOO 들 많네 못 배우고 못 사는 수준 보여 역겹다 라이 짐승 못 한 것 들	FALSE
어머니 모두 위대합니다 삼가 고인 명복 빕니다	TRUE
삼가고인의 명복 빕니다 대통령 님 힘내세요	TRUE
삼가고인의 명복 빕니다 대통령 님 힘내세요	TRUE
피곤하실텐데 며칠 간 쉬시지 부모 상 치른다는게 힘든건데 ᆢ 부디 좋은 국정 일 부탁 드립니다 힘내세요	TRUE
고인 명복 빕니다 대통령 님 마음 추 스리 시 힘내십시요 분명히 어머님 좋은 곳 영 하실 겁니다 반대파 많이 있겠지만 대령 령 님 좋아하는 분 들 훨씬 더 많다는 것 잊지 마시고 바른 나라 꼭 만들어 주십시요 그 래야 우리 아들 딸 들 행복하게 자라지 않겠습니까 경상도 사는 세 넘은 저지 대통령 님 무조건 지지 합니다 식사 꼭 챙겨 드시고 힘내십시요	FALSE
여기 악플다는 OOO 들은 대가 불치 병 걸려서 평생 고생 하다 중환자실 저 세상 갈거다	FALSE
반사 너 그러세요	FALSE
정은 이 얘기 해서 부칸 뿌려랴 고향 보내 드려야지	FALSE
저 질 인생 ㅉㅉ	FALSE
불쌍하네 저렴한 인생	FALSE
장례 치르고 나면 젊은 나이 쓰러지 듯 잠 오는데 좀 쉬시지 마음껏 울 지도 못 지친 마음 몸 쉬틈 없이 복귀 하시다니 ㅜㅜ	TRUE
너 그 들 댓글 부대찌개 들 사람 아닌 줄 알았지만 짐승 줄 몰랐는데 알 해 줘서 고맙다 이 🐕🦜 꾸 들아 그렇게 모질고 독한 말 뿜어내면 느그 인생 좀 좋아질 것 같냐 천만 자꾸자꾸 수렁 빠져들것이다 자자손손 쭈 우욱 오백원 짜리 댓글 달 살아라 아 후 드러워서 아뒤 악취 소름 끼치게 풍기	FALSE
좌파 그동안 악플 많이 달았으나 이번 자제 하는게 옳은거 같다	TRUE
삼가고인의 명복 빕니다	TRUE
고생 하셨습니다 돌아가 신분 보내 드리기 위해 장사 치르는것이 힘들고 피곤한 일 바로 청와대로 복귀 하셨네요 주일 가량 휴가 보내시면서 몸 마음 추 스리 시 오시 힘내시고 건강하세요	TRUE
바로 복귀 하신다니 마음 아픕니다	FALSE
삼가고인에 명복 빕니다 정말 사람 다운 사람 문제 대통령 님 사랑 합니다 ♡♡	TRUE
좋은데 로 가셨을거에요 ㅠㅠ	TRUE
삼가고인의 명복 빕니다 대통령 님 잠시 쉬셨음 좋겠어요	TRUE
평소 병원 통원 치료 하시고 병 있는거 알 장남 가까운 병원 모시 자주 뵙는게 자식 된 도리 거늘 진짜 자주 뵙지도 않고 머나먼 곳 혼자 돌아가시게 했다는게 정말 무심한 불효자 같다 이렇게 무심하니 서민 들 경제 죽어 나가지 휴 김정숙 여사 식비 들어가는 절반 어머님께 정성 들여 보지 휴 무심해서 무슨 말 인지도 모를거 같다	FALSE
계모 거든 이해 하세요	TRUE
지랄 자빠졌네 어머니 한 분 문제 아니고 나라 망가지고 있잖아 어바	FALSE
악플 다는 사람 들 머 하는 사람 들 이해 도저히 못 하겠네 전박통 전전통때같았으면 말 못 꺼냈겠지만 아니면 끌려가서 ᆢ 세상 좋아졌다 민주화 좋긴 좋다 언론 결사 집회의자유 마음껏 누리 ᆢ 내 젊은 시절 비교 하니 확 실시 달라졌고 그렇 다해 걍 악플 ㅉㅉㅉㅉ	TRUE
힘내세요 대통령 님	TRUE
여기 개 못 인간 들 많네	FALSE
나 뇌경색 병발 하신 어머니 여 년 병 수발 했다 간병 후 어머니 돌아가셨을 때 내 나이 세 이 나이 되니 어머니 생사 그리 슬프지 않다 반에 오히려 친구 어머니 돌아가셨을 때 더 많이 울었다 대나 대엔 아무 상관 없는 분 죽음 눈물 쏟아 지지 이 넘고 나면 친부모 사망 큰 눈물 나지 않는다 이 공식 통 하지 않는자 그 위선 자 심하면 사기꾼 더 심하면 악마 젊은이 세상 살면서 느껴 보라 문재인 보다 조금 젊은 나 문재인 사기꾼 또는 악마 본다	FALSE
빨갱이 토착 왜구 이런 단어 좀 그만 써라 할배 할 매 재아 매 들 창피하지도 않은지	FALSE
삼가고인의 명복 빕니다 대통령 님 힘내세요 우리나라 흥 해라 문 대통령 흥 해라	TRUE
삼가 고인 명복 빕니다	TRUE
삼가 고인 명복 빕니다 영 하세요 이 땅 모든 어머님 들 건강하시고 행복하세요 ★	TRUE
그 고생 하셔서 그래도 아들 대통령 자리 앉는 것 보고 가실 수 있어서 참 자랑스러우시지 않으셨을까 합니다	TRUE
탕탕 절 이 거 비교 하는 대한민국 ㅋㅋㅋㅋ 탕탕 절 기념일 없는것 만해 히틀러 나은 대우 해주는거 모르나	FALSE
똑바로 얘기 해 수 백만 명 죽인 히틀러 김씨 조선 악마 들 누구 비교 싶냐 모 지리 아님 뇌 수가 부족한 인간	FALSE
이런 날 북한 미사일 발사 참 북한 지구 상 사라져야 할 존재	FALSE
삼가 고인 명복 빕니다 ㅠㅠㅠ	TRUE
깊은 애도 표 합니다	TRUE
댓글 보면 국민 수준 알것다 이러니 후진국	FALSE
댓글 쓰레기 들 많네	FALSE
대통령 좋아한 적 없었어도 인간 적 또 어머니 있는 아들 로서 위로 마음 전 합니다 삼가고인의 명복 빕니다	TRUE
어머님께 이나라 모든 난국 문제 가지 가셨습니다 대통령 님 힘내시고 국민 들 옆 지키고 있 음 기억 해주세요 어머님 가시는 그 길 우리 가야 될 길 이기 지금 이 순간 어머니 뜻 기억 하며 조금씩 양보 하며 살아갑시다	TRUE
삼가 고인 명복 빕니다	TRUE
고인 명복 빕니다 이제 정말 나라 국민 위해 올바로 이끌어 보세요 나중 잘 했다는 소리 듣길 부탁드립니다	TRUE
대통령 님 힘내십시요 그리고 초심 가려 했던 길 꾸준히 가십시요 묵묵히 응원 합니다	TRUE
좋은 사람 따뜻한 사람 편안하게 다가갈수있는 우리나라 대통령 참 좋습니다	TRUE
삼가 고인 명복 빕니다	TRUE
삼가 고인 명복 빕니다	TRUE
대 광개토태왕 같은 문재인 대통령 어머님 삼가고인의 명복 빕니다	TRUE
악플달지 마세요	TRUE
삼가 고인 명복 빕니다	TRUE
문 대통령 님 힘내세요	TRUE
영 하시 옵소서	TRUE
삼가고인의 명복 빕니다	TRUE
대통령 님 힘 내세	TRUE
위로 말씀 전해 드립니다 힘내세요	TRUE
삼가 고인 명복 빕니다	TRUE
삼가 고인 명복 빕니다 ㅠㅠ	TRUE
명복 빌어	TRUE