사회 혼란 할수록 사이비 종교 판 친다 종북 좌빨 함께 이 세상 없어져야 할 악의 축 신천지	FALSE
그럼 전광훈 이	FALSE
좌빨 같은 소리 하	FALSE
박빠충들 없애야지 ㅋㅋ	FALSE
그 태극기 부대 같이 하는 전 도 그 쪽 이름 다르지 같은데 아님 진짜 기독교 들 다 손절 했다며 보수 약해지니까 좋게 말 하면 신 종교 보통 사이비 같이 세력 확장 하 신정 일치 즉 북한 김일성 주의 지금 보수 우파 진행중 본다 정치 종교 떨어질수 없는거라고 들 하지만 대놓고 대중 앞 종교 계 인사 하나님 까불지마 하는 사이비 필두 선전 선동 하 허락 하다니	FALSE
김일성 북한 현실 지도자 였고 곧 종교 한국 당 하나님 죽이는 신종교 전 의 종교 새로이 받아들이고 정당 종교 색 종교 정치 색 가미 해 동반성 장 획책 하니 이는 남 한판 조선노동당 건설 계획 할 수 있다	FALSE
요새 한국 당 하는 말 들어 보면 보수 이데올로기 약해지니까 계속 당 힘 집중 시키던데 니 들 무슨 자유 민주주의 추구 하는 정당 조선노동당 완성 낮은 조선노동당	FALSE
전광훈 목사 좀 쳐내 보시오 중세 기독교 국가 재건 할거요 이렇게 해 이 하나님 명령 못 한다고 사탄 마귀 들었네 불로 태워라 태워서 산다 인정 한다	FALSE
사이비 종교인 최태민 세력 탄핵 정국 사라지니 그 빈 공간 다른 사이비 채워 넣은거라고 변명 해	FALSE
내 대통령 되면 사회 어지럽히고 악행 일삼 는 사이비 이단 모조리 잡아 참수 할꺼 임	FALSE
일 베틀 딱 들 얘기 아니고 자 한당 정권 못잡으면 나라 망하라고 가짜 뉴스 사회 혼란 야기 하는게 일 베틀 딱이잖 앜 ㅋㅋㅋㅋㅋㅋㅋㅋㅋㅋ 신천지 뭐 다름	FALSE
정상 적 인간 들 문재인 김어준 같은 사람 지지 안함 진짜 사이비 빠지거나 그럴 가능성 있는것 들이 저런 놈 들 심취 해서 어떻 게 자신 들 정상인 것 포장 함 그 활동 일환 포교 남 들 사이비 빠져야 자기 정상인 되거든 평생 남 들 무시 받고 손가락질 받는것 들이 끼리끼리 뭉쳐서 생긴게 호남 향 우회 사이비 문빠같 똘갱 집단	FALSE
정상인 일베 같은거 안 어벙 집회 같은거 안나 혼자 거품 물 세상 좀 똑바로 봐라	FALSE
대 깨문 일베 메 갈 신천지	FALSE
틀 깨문 공산주의 빨갱이 페미 신천지	FALSE
lkr 종교 왜 존중 해야하나 종교 믿는것 들은 전부 정신 이상자 들	FALSE
구글링 하면 나옴	TRUE
개 무섭네	TRUE
신천지 민주당 대한민국 암 적 존재 들	FALSE
여기 민주당 왜 나오지 웃기	FALSE
기사 관계도 없는 댓글 이나 쓰는 친일 당 지지 자인	FALSE
요즘 기사 내용 한 번 읽고 무조건 더불어 민주당 엮어 댓글 써야 돈 준다고 시키나 봐요 ㅋㅋㅋㅋ	FALSE
대 깨 빤 뜬금 없는 댓글 질 웃고 간다	FALSE
자 한당 겠지	FALSE
신 천 지애 들 대부분 여자라서 페미 주의 강함	FALSE
어디서 홍어 냄새 난다야	FALSE
민주당 왜엮 어 너나잘햐	FALSE
자 한 당 냄새	FALSE
자 한당 지지자 수준 일 베틀 딱 수준	FALSE
도로 새누리당 포함 시켜줘 섭섭하게시리 왜 빼	FALSE
신천지 순우리말 하면 새누리 입니다 그냥 그렇다고요	TRUE
민주당 후 빨러 들 역겹다	FALSE
여윽시 네 일베 본진답게 토왜 들 살판 났죠	FALSE
신천지 새누리당 선거운동 했었다 뉴스 검색 해봐라	FALSE
민주당 암 적 존재 맞지 허구 언 날 데모 했던 놈 들 정권 잡고 거만하게 구 데 암 적 존재 아니면 뭐	FALSE
신천지 자 한당 대한민국 암 적 존재 들	FALSE
너 같은 문천 들이 제일 문제	FALSE
민주당 왜 뺌 ㅋㅋㅋㅋ 문 천지 제일 문제 같은 뎈 ㅋㅋㅋ	FALSE
암 덩어리 중 최고 문 재암 대한민국 말아먹은 역적 #민주당만 빼고 달창 들 댓글알바 지령 받아도 좀 창의 적 이어 봐라 좀 신천지 뜬금없이 자 한당 드립 하면 그저 달 창의 모자란 머리 드러내는 꼴	FALSE
신천지 문 재앙 열성 편	FALSE
느근혜 달이 똑같 제 뭘 따지고 드냐	FALSE
경제 ㅈ 같은데 그거 한 마디 했다고 달려들어 물어 뜯는 ㄹㅇ 홍위병 조선 패치 실천 중인 대 깨문이 이 걸 물 타 기한 다 고 엿 이나 드셔 ㅗ	FALSE
민주당 빼고	TRUE
이 댓글 절 웃긴게 신 천 지애 들 대부분 여자라서 페미 주의 절 강함 ㅋㅋ 성향 여성 평화 남북 평화 이런 쪽 ㅋㅋ	FALSE
ㄴ 그래서 넌 딱 생각 하는 수준 보니 일베	FALSE
문천 ㅋㅋㅋㅋㅋㅋㅋㅋㅋㅋㅋㅋ 찰떡 ㅋㅋㅋㅋㅋㅋㅋㅋ	FALSE
대 깨문이나 신천지 사이비 종교 맹목 적 추종 면 일맥상통 하는 면 있음	FALSE
이만 희는 신 아니다 신천지 사이비	FALSE
이만 희 교주 유부녀 꼬셔 놀아 나다가 팽당 저런 놈 신 믿고 종교 핑계 돈 갈취 윗 선 들 돈 헤 먹는데 아무 것 모르고 열심	FALSE
신천지 통일교 그냥 미사일 쏴서 없애 버려 야할 개 사이비종교 임 ㅋㅋ	FALSE
아니 신 천 지애 들 왤케 수법 안 바뀌냐 심리상담 퍼스 널 컬러 그딴 거 신선한 것좀 가지 와 ㅋㅋㅋㅋ	FALSE
신천지 악마 숭배	FALSE
번 환자 신천지 ㅇㅇ	FALSE
신천지 사모 김남희 폭로 이만 희의 실체 알고도 신봉 하는 사람 들 도대체 누슨 생각 건지 빨리 정신차려서 가족 들 가슴 못 박는 짓 그만두길	FALSE
명륜 교회 이름 정확히 밝히고 폐쇄 조치 해놓고 신천지교회 왜 이름 쏙 빼고 두리 뭉실 대 구 교회 하는지 모르겠네요 대구 신천지예수교 회 다대오 성전 얼른 폐쇄 조치 시키시죠	FALSE
전광훈 대표 단체 사이비 지도 층 인사 대중 영향력 큰 사이비 목사 대통령 막말 하나님 친구 하는게 더 사이비 왜 신천지 같은 곳 교인 빼앗기나 전광훈 원로 목사 입네하는 넘 들이 정치 하 하나님 인간 중계 자라 자처 하는 넘 들이 더러운 입 하나님 방패 삼아 종교 더럽힌다 신천지 옳은게 뭐 조 그만 교회 주님 바라보는 목사 님 들이 불쌍하다	FALSE
맞다 게보린	TRUE
가정 파괴 인성 파괴 가출 이혼 조장 하는 사이비 신천지 여러분 들 조심하세요	FALSE
신천지 가 이단 사이비 종교 는걸 신천지 사람 알고있더라 구 빠져 나오기 힘들 뿐	FALSE
신천지 싹 다 처리 하면 우리나라 평균 아이큐 오를듯	FALSE
신천지 대 깨문을 놓고 사이비 종교력 대결 하면 누가 이길지 문득 궁금해진다 에일리언 대 프레데터 처럼 누가 이겨도 미래 없겠지만 ㅋㅋㅋㅋㅋㅋ	FALSE
박사모 이김 ㅅㄱ	TRUE
이만 희 님 신도 병문안 가셔야죠 물론 영생 하는 신이시니까 마스크 필요없겠죠	FALSE
신천지 내 접촉 자 들 접촉 사실 비밀 하라 공문 올라왔습니다 추천 해서 올려주시고 대구 분들 그 주변 지역 분들 볼수 있게 해주세요	FALSE
근데 그 신천지 교도 코로나 걸려서 같이 예배 드렸다며 다 같이 걸리겠네	FALSE
신천지 이상한거 아는데 국민일보 순복음교회 조용기 좀 웃김 ㅎㅎㅎㅎ	FALSE
이상한 거 아는데 신천지 겠냐 ㅡㅡ	FALSE
국내 신천지 능가 하는 광신도 집단 있지 문빠 대 깨문 들	FALSE
사이비 기준 전광훈 vs 신천지 도데 체 기준 뭐	FALSE
이미 대구 남구 대명로 대덕 빌딩 다대오 파 본부 다니는 번째 확 진자 신천지 교인 이 곳 환자 번 갔다는 대 구 교회 중국 신천지 골칫거리 작 금 한국 코로나 전염 확산 시키는 진원 지다 당장 교주 이만 희를 잡아들여서 족쳐라 죄명 코로나 전염병 확산 주도한 죄악	FALSE
신천지 중국 갔다 와서 발열 하는데 신고 안 신도 있을 듯 이 사람 퍼트렸 듯	FALSE
생각 있는 사람 들 사이비 안 믿습니다 그리고 제발 우리나라 정부 인정 하는 종교 믿읍시다	FALSE
김남희 씨 다 폭로 했는데요 ㅋㅋ 팀킬 ㅋ	FALSE
저런 사이비 집단 제거 되 야한다	FALSE
이번 대구 감염 자 신천지 정신 좀 차려 ㅋㅋㅋㅋㅋㅋㅋ 이만 희가 있으니 코로나 안 무섭지	FALSE
좋은 정보 감사합니다 멀쩡한 교회 의심 할 뻔했네요	TRUE
신천지 교주 죽으면 누가 이어가려나 근데 예배 갔으면 대구 사이비 신도 들 불안 불안 사이비 신도 거 밝히 자니 창피하고 그렇다고 돌아다니 자니 벌금 무섭고 ㅋ	FALSE
신천지 새끼 들 발악 하네 누구 인생 조지 려고	FALSE
이제 신천지 끝난것인가 코로나 환자 동선 걸린 모든 것 폐쇄 한다는데 신천지 피해 갈수 있나 모르겠 네 대구 통신원 분들 사후 이야기 올려 주세요 ㅊ	FALSE
이만 희가 죽어야 깨 달을까 불쌍한 신천지 사이비 교	FALSE
걔네 들 이만 희 닮은꼴 미리 구해 놨 거 같은 삘 이만 희 죽으면 이만 희 대타 시키려고	FALSE
교회 다 똑같은 것 들이지 종교 사회 악	FALSE
신천지 비롯 해서 한국 의 는 사이비 교주 들 경영 하는 이익 집단 업주 들 철저히 파악 해서 능지처참 해야 한다	FALSE
대구 번 환자 신천지 데	FALSE
이단 사이비	FALSE
개 사기꾼 새끼 들 ㅋㅋㅋㅋ 돈벌레 교주 밑 하는게 그렇지 뭐	FALSE
신천지 이만 희를 영생 하는 자로 받 들면서 본인 들 영생 할거라 믿는 종교사 기 집단 입니다 길거리 설문조사 인터뷰 요청 거진 신천지 조심하시길 바랍니다	FALSE
신앙 인 기본 자세 무엇 하나님 그리고 듣는 귀 무조건 아니다 가 아니라 이 사람 왜 나 이런 말 할까 하고 하나님 곧 성경 찾고 묻는 것 이 기본 알아도 욥기 처럼 하나님 너희 복 주실 것 그렇다면 정말 우리 바라는 복은 무엇 예수님 구약 선지자 하신 말씀 다 이루시고 십자가 죽으셨다 죄 의 값 해결 하시고자 그 죽으신 피값 우리 사셨다 기록 되어 있다 계시록 이치 상 죄 때문 사망 왔고 그 값 치뤘으니 영생 아니냐	FALSE
요한 서 장 절	TRUE
너희 안 이 마음 품으라 곧 그리스도 마음 오늘 아침 이 성경 보게 하시더라 하나님 창세 모든 계획 세우시고 그 하신 말씀 이루시고자 성경 천년 동안 일해 오셨으며 그 안식 할 것 말씀 하셨다 하루 천년 천년 하루 그 마침표 계시록 그 하신 말씀 끝 통치 하신다는 것 모두 바라던 바 그 기다림 끝 하나님 의 하신 말씀 이 세상 흘러 왔다 그러나 그 하신 말씀 성경 보는 자 안 보는자 로 갈림 그 또한 마지막 심판 하나님 뜻 아멘	TRUE
개독 말 많아 자기 신앙 자랑 싶어해	FALSE
신천지 우리말 새누리	TRUE
경상도 놈 들 그만 사기 좀 쳐라 구원파 유병언 이 대구 신천지 이만 희 도 경북 청도 출생 대 구 성전 본 산지 조용기 목사 울산 하다못해 요새 자주 등장 하 정치 목사 전광훈 경북 의성 대한민국 금융 사 기범 조희팔 경상도 아 진짜 니 들 주둥아리 그만 놀려라	FALSE
세상 어찌될런 후 신천지 사이비 종교 문슬람 사이비 종교 판 치니	FALSE
아이고 그래서 대표 다가 번 확 진자 그 분 부르 심 받고 감염 자 되어서 기도 힘 보여주기로 한거군요 닝기미	FALSE
국민일보 남 들 헐뜯 기전 니 들 거짓 뉴스 사 기 뉴스 들 하지마라 신뢰 살아야 그때 서야 거짓 진실 하는말을고지 곳 믿어주지	FALSE
진짜 정신 병자 들	FALSE
개천 없애야해	FALSE
한기총 ㅈ 같은 단체 건 맞는데 신천지 한기총 해체 하 cbs 해체 하 하는거 보 이 것 들 문 재앙 정권 끄나풀 들 아녀	FALSE
다른 종교 신천지 똑같대 ㅋㅋㅋㅋ 사이비 올려치기 쩌 이 때 싶어 지역 혐오 정부 욕 병원 탓 하 것 들 그냥 다 신천지 뭐 멘탈 같으니까	FALSE
역쉬 발 빠른 대처 ㅋ	TRUE
저런 쓰레기 믿는 인간 들 더 쓰레기	FALSE
근데 신천지 신도 걸려부맀	FALSE
질병 세상 살이 시련 종교 신앙 힘 이겨 낼 수 있다 생각 하는 것 들 백약 무효 잉여 인생 기본 적 도와줄 필요 없음 종교 자아 성찰 위 도구 무엇 해결 해주는 마법 지팡이 여기니 종교 업자 들의 배 점점 불러가지	FALSE
한국인 대단하구나 군사력 세상 지배 하기 힘들다고 판단 되니까 종교 나서네 통일교 해외 선교 활동 하는 줄 알았는데 신천지 정말 신천지 개척 하네 그런데 해외 포교 좋고 선교 좋은데 좀 욕좀 들어 먹지 합시다 국내 여러가지 불만 비리 말 많더만 해외 가서 나라 망신 시키지 좋은 종교 활동 합시다 가정불화 가정 파탄 내지	FALSE
얼마나 지능 낮으면 저런데 빠지는 거	FALSE
신천지 맹신 도나 구원파 유병언 맹신 도나 주사파 맹신 도나 대 깨문 들 태극기 부대 한결같이 비판 적 사고 능력 없는 존재 들 이 들 사회 망치 민주주의 망친다	FALSE
그게 싫음 북한 가야 엄연히 종교 자유 있는거니 사이비 뭐 지 들이 믿느게 종교 하면 어쩔 수가 있니	FALSE
종교 자유 때문 독재 국가 아니면 정부 마음대로 못 함 이 같은 이유 미국 몰몬교 사이언톨로지 등등 여러 사이비 종교 들 못건 드는거구요 이 어떻게 보면 민주주의 단점 이 국민 들 멍청하면 나라 그냥 개판 되어 버리는데 손 쓸 명분 없으니	TRUE
무신론자 들 입장 대 한 예수교 장로회 사이비 종교	FALSE
국민 들 똑똑하면 된다 나라 뭘 자꾸 요구 많은 권한 주면 지금 사이비 교주 대통령 하고 권력 휘두른다	FALSE
내 위 댓글 쓴 달창 세 마리 문슬람 사이비 종교 신도 듯	FALSE
최태민 육적 베필 누구	FALSE
ㄴ 니 네 엄마	FALSE
문슬람 사이비 종교	FALSE
저 헌금 어디 쓰일 것 같아 이만 희 혼자 다 쓸것 같아 돈 많으면 사람 모이는 법 정치 경찰 끈 없을까	FALSE
근 대 국가 정치 종교 분리 되어 있기 때문 이 종교 정치 개입 하는 것 정치가 종교 탄압 하 거나 이용 하는 것 민주주의 어긋나거든요	FALSE
종교 자유 신천지 허용 한다는 것 종교 자유 아니라 사기 자유 하는거야 종교 다르게 해석 왜곡 하여 만드는 종교 사이비 사기 거지	FALSE
어릴 때 별 생각 없이 친척 따라 엄마따라 교회 열심히 다녔는데 머리 크면서 언젠가 부터 목사 말 돈 달라 소리 들리기 시작 하더라 그 뒤 종교 대한 생각 바뀌었다 그냥 다 똑같다고 생각 한다	FALSE
쟤 네 정치인 들 바치는 돈 또 어마어마하거든	FALSE
사이비 구분 뭘 할건데	FALSE
이만 희는 목사 아니라 자칭 하나님 한다이만 희가 거 짖 교주 해도 한번 신천지 빠지면 가족 버리고 부모 형제 원수 생각 한다 왜눈 가리고 귀가 가렸기 때문 저 들 신학 없다 고작 배우는 것 성경 이 말씀 무슨 뜻 비유 풀이 한다 그 래야 이만 희가 하나님 되기 때문 가짜 해도 지금 신천지 니 ㅡ 오지 않는 불쌍한 사람 들 너무도 많은 숫자 있다는 것 문제	FALSE
원 본 영 상속 즈음 마니왈 여보 잘 못 했어요 내 다 잘 못 했어요 그러니 돌아와요 우리 이러지 맙시 내 잘 못 했어요 배도 자라며 배도 자 용서 비는 꼴 뭐 그리 숨길것이 많은지 사람 하나 놓지를 못 합니까	FALSE
도대체 팬티 목사 따르는 태극 할배 신천지 통일교 사랑 교회 소망교회 교회 교회 종교인 이렇게 많은지 다 천당 가면 지옥 좀 비 있겠네 생각 해 봐야 겠네여	FALSE
skad 할배 다 좋 네 여 친일 자식 뽑아주지 맙시	FALSE
이단 들 성령 없습니다 오직 성령 예수 그리스도 시인 할 수 있고 하나님 부를 수 있는데 비진리 가지 풀이 하려니 문자 적 글자 적 해석 못 하는 겁니다	FALSE
ㄴ 성경 오류 빼고 문자 적 글자 적 해석 하는게 맞죠 자기 주관 빼고 있는 그대로 성경 해석 하면 신천지 같은 곳 나올 수 없음 무식한 사람 들 기본 적 독해 문법 무시 지 맘대로 해석 하는 것 철학 책 비유 한다면 칸트 책 지 맘대로 비유 해석 해서 토테미즘 끌어내면 얼마나 웃기 해석 자유 라지 있는 그대로 칸트 아니고 그 이탈 심하면 망상 임 마찬가지 신천지 그냥 무종교 인 무심 성경 보고 읽으면 프로도 나올 수 없는 거대 망상 임 ㅋ	FALSE
맹자 측은 지심 말 했더니 측은 지심 프랑스 마을 이름 식 이 뭥미 그 정도 수준 과대망상 성경 이용 하는게 신천지	FALSE
다시 오시 예수님 영 오신다는 증거 ㅣ 조 회수 http :/ /www.shincheonji.kr/bv_newsDisproof_1892 예수님 십자가 지시 장사 된 지 사흘 부활 하실 때 영 아닌 살 뼈 있는 육체 부활 하신 것 맞다 그래서 고기 드시고 육신 만져 보라 말씀 하셨다 눅 눅 ∼ 못 박힌 손 발 보이시 생선 드시니라 하셨다 그러나 이 것 주의 거룩한 자로 하여금 썩음 당 치 않게 하신다는 예언	FALSE
이루기 위함 시 행 시 이는 내 영혼 음부 버리지 아니하시며 주의 거룩한 자로 썩지 않게 하실 것임 이 다행 미리 보는 고로 그리스도 부활 하 심 말하되 저가 음부 버림이 되지 않고 육신 썩음 당하지 아니하시리라 하더니하지만 문 들 닫혀 있을 때 들어오기도 하시고 요 장 말씀 하시다가 갑자기 사라지 기도 하신다 눅 그러면 부활 후 이 땅 간 계시다가 승천 하신 후의 예수님 육체 영 만약 예수님 육체 승천 했다면 하나님	FALSE
ㄴ 신천지 보고 과대망상 무식하면 약도 없다 신천지 성 경 말씀 가감 없이 성경 가르치는 곳 입니다 한번 확인 해보세요 반면 성경 없는 주석성경 가르 키 곳 어디 일까 요	FALSE
하나님 영 천군 천사 들 영 들 가득한 영 세계 예수님 혼자 육체 입고 있다는 것 신천지 측 주장 예수 영 부활 했고 그 영 재림 하는데 그 영 이만 희에게 와서 이만 희가 재림 예수 것임 그리고 이 내용 신천지 측 반박 글 일부 다 복사 할수는 있는데 그럼 거의 댓글 개는 나올테니 여기 일부 봐도 신천지 들 과대망상 성경 이용 하는 예시 들임 분명 문자 그대로 예수 부활 영 이 아니라 믿건 안 믿건 성경 육신 동반 부활 애기 있음	FALSE
그러나 신천지 일단 성경 나온 그 문자 그대로 내용 언급 뒤 그것 보이는 건 예언 이루기 위 함이었다고 얼렁뚱땅 애기 후 넘기고 이 젠 부활 예수 일반 적 육체 존재 자의 한계 넘은 모습 역사 한 것 승천 이후 세계 가정 하면서 결국 그럴 리 없다 말 안된다 그러니 아니지 즉 자신 들 주관성 개입 시키면서 왜곡 함 근데 그럼 영은 영 체 없어야 하는 이유 있나 천사도 존재 한다면 영일 텐데 구약 보면 육신 보이는 모습 나타났다 믿건 안 믿건	FALSE
성경 그대로 봐라 영 꼭 반드시 눈 안 보이거나 둥둥 떠다니는 형체 여야 하나 형체 벗 수도 있고 입 수도 있잖아 성경 문자 그대로 봐라 여호와 불과 구름 나타났고 성경 환상 천사 장로 들 천국 영 체 입고 나타났고 또 신기한 짐승 천국 있는걸 구약 선지자 봤음 믿건 안 믿건 성경 영 체 있잖아 그대로 봐라 근데 왜 자기 과대망상 왜곡 함 신천지 모든 주장 다 이런 식임 걍 기본 독해도 안되는 저능 함임 또한 예수 영 이만 희만 받아서 특별하다는 사상 자체	TRUE
성경 문자 무시 하는 과대망상 사이비 임 육신 있는 자 들 하나님 기쁘시게 할 수 없느니라 만일 너희 속 하나님 영 거 하시면 너희 육신 있지 아니하고 영 있나니 누구 그리스도 영 없으면 그리스도 사람 아니라 또 그리스도 너희 안 계시 몸 죄 말미암아 죽은 것 영은 의 말미암아 살 있는 것 이니라 로마서 장 믿건 안 믿건 모든 참된 신자 그리스도 영 받고 그 영 의해 변화 되고 구원 길 간다 문자 그대 말함 예수 영 뭔 특별한 사람 임 하냐	TRUE
문자 무시 성경 기본 독해 무시 그러니 사이 비질 하는 것임 애초 일단 신천지 기본 없는 성경 책 자신 들 주관 적 망상 개입 시켜 맘대로 이용 하는 집단 일 뿐임 그러나 말 했다시피 그런 짓 정통 교회 설교 자 들 마구 저질렀기 때문 이런 핵 무식 기본 문법 독해 파괴 하는 짓거리 횡행 하는것 지 꼴리는대로 해석 문제 학적 가치 도 없음 걍 지 하고 싶은 말 교훈 나열 될지 몰라도	FALSE
바보 들 아냐 왜 그딴 거 정신 못 차릴까 인간 어떻게 신 되냐 정신 들 좀 차리자	FALSE
마귀 속 서 그렇습니다 지금 전세계 재앙 이르게 하는 죄 음란 교만 거짓 입니다 그래서 많은 사람 들 회개 하지 않으면 더 크고 무서운 심판 있을것이고 그 재난 통해 결국 많은 사람 들 하나님 찾게 된다고 성경 증거 합니다 죄악 회개 해야 합니다	FALSE
재앙 입니다 문 재 앙 대 깨 문 달창	FALSE
자 한당 토종 쪽바리 일베 틀 딱 태극기 부대 경상도 문 디 들 이 넘 들이나 뭐 다르다고	FALSE
그래도 사교 집단 문 천지 교 광신자 들 낫내 내부 폭로 자도 있고 문 베 들 안그	FALSE
머 미친 개 소리 지랄 풍년 일세	FALSE
애초 신 이란 건 인간 만들어 낸 개념 그 비슷한 것 존재 한다 해도 인간 생각 하는 신 전혀 다르다 아이 뉴 타인 상대성 이론 시간 공간 하나 차원 일 뿐임을 밝혀낸지 이 넘었고 빅뱅이론 이름 이론 이미 사실 상황 인간 만든 신은 우주 창조주 로서 기능 이미 상실했다 그리고 자연법칙 말 그대로 법칙 예외 있는 것 아니라는 점 세상 마음대로 할 수 있다는 전지전능함 역시 모순 생긴다 만약 신 있다고 한다면 그것 자연 일 것 자연 신 개념 그나마 인류 가장 나은 설명	FALSE
사기꾼 나 사기꾼 하고 사 기 칩 알지도 못 하면서 함부로 말 하지 마세요 자기 대놓고 하나님 했겠습니까 상식 누가 따라갑니까 하나님 함께 한다 주의 종이 하고 시작 하는 겁니다 교회 안 그렇습니까 목사 님 들도 주 의종 들 아닙니까 하나님 사랑 갈급 해서 찾는 사람 들 속 겁니다 교회 말씀 수준 형편 없으니 저런 곳 나온 말씀 움직여지는 겁니다	FALSE
나라 꼴 이 모양 그렇습니다 지금 국민 들 선동 해서 이니도 대통령 하는 마당 저런 사이비 홀리 사람 들 이해도 갑니다	FALSE
애초 신도 인간 만들어 낸 건데 뭔 신 돼	FALSE
구약 한 사자 약속 되어 있듯이 신약 한 사자 약속 되어 있다 약속 맞는 사자 누구 다	FALSE
쟤 들 거의 대 깨 문 급	FALSE
와 문재인 숭배 십덕 달빠 돼지 여자 들 공격성 봐	FALSE
저 것 다 가짜 빠지게 만드신거겠지 다만 하나님 자녀 빠져있다면 어떻게 서든 빠져나오게끔 해주시겠지	FALSE
Cheo 그게 니 들 교주 아웃 곀 ㅋㅋㅋㅋㅋ	FALSE
Vnld 교육 제대로 받으셧 대박 ㅋㅋㅋㅋㅋㅋ	FALSE
우리 엄마 돌려 놔라 사이비 것 들	FALSE
위 박 그네 박사모 자칭 보수란 것 들 더 광신도 들	FALSE
예수님 이름 기도 하세요 이단 싸움 육적 싸움 아니라 보이지 않는 영적 싸움 입니다 그래서 성령 도우 심 예수님 도 달라 기도 하시면 하나님 아버지 반드시 도 우실것 입니다	TRUE
똥 싸라 저 사람 부모님 사이비 빠져서 걱정 있는데 하는 말 기도 하라	FALSE
신천지 애 들 절대 천국 못 감 ㅋㅋㅋ	FALSE
무교 입장 종교 보면 믿고 의지 할 곳 있어서 부럽 기도 한 데 저런 사이비종교 은 참 안쓰러울 뿐	FALSE
종교 때문 힘든 사람 기도 하 말 진짜 어이 없겠지만 요 사람 어떻게 할 수가 없는 문제 거 이미 너무 잘 아시잖아요 ㅠㅠ 종교 무엇 알기에 가족 사이비 빠졌다면 그 참담함과 피해 얼마나 클 지 짐작 가서 드릴 말씀 기도 하시라는 말 뿐입니다 ㅠㅠ 못 이기는 척 밑 져야 본전 생각 하시고라도 하나님 기도 하시라고 감히 권 해드리고 모르는 분 같이 기도 하겠습니다 부디 가정 평안 다시 회복 되길 기 도합 니	TRUE
맞아요 저 초등학교 학년 때 어머니 깜빡 속 서 신천지 교육 센터 같은 곳 다녔었는데 제 워낙 어렸을 때 사이비 거 알아도 주변 도움 요청 하지 못 했어요 대신 매일 속 기도 바랐더니 도 안 돼서 정식 교회 집사 님 잘 못 된 거 아시곤 어머니 신천지 꺼내주셨어요 아마 신천지 같은 사이비 속 는 사람 들 의지 할 데 없고 마음 고독 하실 거 옆 잘 해드리면서 기도 열심히 해보세요 ㅠㅠ 지푸라기 잡는 심정 요	TRUE
우리엄마 두 요 ㅜㅜ	TRUE
우리 어무니	TRUE
진짜 많네요 ㅠ 김남희 씨 신변 보호 필요합니다	TRUE
우리엄마 지금 몇 년 짼지 꼭 거길 다녀야하는지 그냥 교회 안다니면 안되는지 이만 희 그 새 끼 무 ㅓ 가족 중요한지	FALSE
우리 대 깨문 들 요	FALSE
저희 사무실 건물 아래층 신천지 보이는 간판 제대로 안달 안 인테리어 대충 해서 교육 하는 교육장 벌써 두 개 되더군요 엘베 같이 탈때 보면 대부분 맘 착하시고 어디서 상처 깊은 분들 현혹 시켜 그렇게 교육 하는 모습 분개할 때 많습니다 적어도 이런 사이비 종교 자유 좀 제외 시켜야 하는게 아닐까 요 거의 사기 가까운 데 이 것 종교 자유 부분 덮어 두기 너무 심각하다 생각 합니다	TRUE
죽일 ㄴ 들	FALSE
전국 많아요 ㅋㅋ 간판 없이 신 천 지운영 무슨 다단계 마냥 목걸이 카드 찍어야 문 열리는 시스템 다른사람 들 모름 ㅋㅋㅋㅋㅋ 진심 헌금 내는건 둘째 신천지 신문 달력 공책 성 경 말씀 면목 하 씨디 테이프 어플리케이션 등 엄청 돈 주고 사라 꼬시는 더 웃김 ㅋㅋㅋㅋㅋ 다른 거 비싼데도 그리 사데 신도 들 ㅋㅋㅋ	FALSE
착하 보이 가면 입니다 ㅠㅠ 이단 하고 신천지 나오면 바로 개돼지 욕함 제 그 욕 들었네요 ㅎㅎ 걔네 들 설명 해도 안 들음 귀 막 눈 막음	FALSE
@beau 헐 조심하세요 ㅜㅜ 무서운 사람 들입니다	FALSE
넌 삼단 아니 사단	FALSE
열거 교회 다 사이비 맞아요 뭣 모르고 하나님 교회 갔다가 젊은 엄마 들 꼬셔 다 데려다 놓고 아줌마 들 계속 전화해서 만남 유도 해요 아무튼 사이비 종교 다단계 매 한가지 같아요 빠지면 나오기 힘들어 보이더라구요 안타까 움	FALSE
여의도 순 복음 사이비 아닌가 ㅋㅋ	FALSE
저 것 들 싸이 비 맞아요 혹시 믿으 신다면 한강 다이빙 추천 드립니다	FALSE
여러 대학교 들 앞 스터디 카페 가장 해서 학생 들 속 있는데 제발 법적 단속 좀 해주세요	FALSE
너 이만 희도 같은 종자 가정 잇고 애가 두 명인 데 저럼 사기꾼 몸 바치 종교 이단 시켰어니 많은 사람 피해 입히고도 재산 때문 소 송전 걸고 폭로 하고 돈 욕심 이나 그러는거지 신천지 신도 피해 입고 가정 박살 난 사람 뭐라고 변명 할대 이만 희 저 놈 악마 너 악마	FALSE
그게 그렇게 간단한게 아녀 신천지 이만이 신 넌 신의 명령 거부 할수있니	FALSE
사기 당했다 잖아 김남희 씨 피해자 같은데	FALSE
피해자 무슨 ㅋㅋ 가정 있는 사람 저딴 터 무니 없는 것 속 넘어가는게 정상	FALSE
피해자 무슨 물 빨 놀다가 이제 돈 챙길라고 그러는 겨	FALSE
김남희 피해 자임	FALSE
지인 할머니 신천지 돈 다 내고 돈 떨어지니 돈 못 넣으면 오지말라고 당신 구원 받을 수 없다 헛소리 했다더라 그 할머니 애 타서 대출 받으 려 참 못 된 늠 들	FALSE
신천지 나온 사람 이건 사실 아닌 듯 돈 떨어지면이 아니라 다른 이유 있을 겁니다 일단 신도 되면 돈 못 넣어도 전도 하 해서 부려 먹습니다 다만 여긴 건축 헌금 반 강제 적 안드레 제주 성 전 건축 헌금 최소 이상 총회 과천 건축 헌 금은 인당 최소 이상 내 반 강제 약 정해 야함 저 만 낸 상태 나왔는데 대학 학년 아는 동생 다 내고 참고 걔네 엄마 병상 있고 일도 못 누워있었는데 엄마 신천지 건축 헌금 우선 내더라고요 걘 학점 다 F 맞고 ㅠㅠ	FALSE
신천지 계시는 청년 여러분 힘든거 압니 그런데 아무리 힘들어도 거 긴 아니에요 고개 한번 돌려 보면 실체 보입니다	FALSE
못 빠져나가게 막 조폭 뭐라 했던데	FALSE
개신교 무리 들 한기총 하는 짓거리 해명 좀 해봐라 그게 종교 이단 사이비 집단 실체	FALSE
ㄴ 신천지 여호와증인 하나님의교회 소속 밝혀 ㅋㅋㅋ 왜 떳떳하지못하고 맨날 개신교 한기총 욕 하 아 신천지 한기총 전단지 만들어서 맨날 우리 현관문 끼워 넣더라 ㅋㅋㅋㅋㅋㅋㅋ 티나 신천지 ㅋㅋㅋㅋ	FALSE
신천지 구나	FALSE
신천지 이렇게 댓글달라고 공지 내렸나요	FALSE
과거 과거 일 뿐 이제 신천지 내부 사정 폭로 하는 김남희 올 바른 거지	TRUE
김남희 씨 응원 합니다 모든 정황 봤을 때 김남희 씨 증언 타당 합니다 증거 있으니 말 입니다 하지만 신천지 정황 증언 증거 모든 타강 한 게 없습니다 비난	FALSE
신천지 종교 인정 해 주는 것 문제 임 저건 그냥 사람 졸라 많은 단체 집단 임 그리고 길거리 싸 돌아 다니지 좀 말던가 말 걸지 말던가 졸라 걸리 적거려 사람 앵 간치 많아야지 짜증나게 무슨 유월절 알려 준다고 맨날 똑같은 멘트 있어 바빠 죽겠는데 그리고 내 친구 돌려줘 순진한 사람 들 꼬셔 주머니 털어가지 니 네 직접 돈 벌어서 써라	FALSE
신천지 주변 너무 많아요 정말 심각합니다	FALSE
시 모 시누이 시누이 남편 시 조카 다 신천지 네 정말 심각합니다 말끝 악마 얘기 이만 희를 신 생각 ㅋㅋㅋㅋ 신천지 지금 돈 갖다 바친게 어마 무시못 해 거기 다단계 속 맨날 물건 값 배는 내고 사오네요 ㅋㅋㅋㅋㅋ 멍청한 건지 답답하네요	FALSE
한 번 빠지면 가족 친 인척 지인 할 것 없이 수렁 끌 들어가더라구요 종교 것 참 한번 잘못 빠지면 그 수렁 헤어 나오지 못 하니 무서운 것 같아요	FALSE
그래도 다행 김남희 씨 모든 진실 까발려서 이단 한 개인 가족 사회 국가 세계 망 뜨 리 악마 들	FALSE
제발 신천지 빠진 분 들 어서 빠져나오세요	FALSE
기독교도 그 나물 그 밥	FALSE
저녁 쯤 올라온 동영상 잘 봤습니다 부터보면 이마 니 김남희 씨 여보 잘 못 했어요 정말 잘못 했어요 그러니 돌아와요 애 타게 용서 비는 녹취 있습니다 충격 입니다 이 긴자 자가 숨길것이 뭐 그리 많은지 사람 하나 붙들고 매달리는 꼴 니요	TRUE
신천지 요즘 선행 하는 척 하면서 집단 적 댓글 조작 해서 사이비 이단 이미지 벗으려고 하는데 하는 짓 보면 가정 파탄 내고 성적 굉장히 문란하고 역겨 움 모두 사이비 이단 신천지 조심하세요	TRUE
사이비 빠지면 그게 믿어집니다 그러니 지금 몇십 만 명의 사람 들 신천지 기타 사이비 빠지겠죠 저 사람 한 시간 가량 증언 한 게 있는데 저 사람 이만 희한 테 꼬여서 자기 재산 바쳐서 신천지 헌납 했고 잘못 된거 깨닫고 그거 일부 지키려고 법정 소송 신천지 대형 로펌 써서 소송 준비 한다 합니다 저 여자 편 드는건 아닌데 피해자 한 둘 아니라서 믿어지게 된다는거 이해 합니다 무 튼 동영상 들어 보면 기 막힙니다	FALSE
신천지 신도 들 제발 정신 좀 차리자 거짓 사기꾼 속 서 나중 땅 치 후회 하게 된다	FALSE
신천지 이 것 들 왜 양 아치 신분 숨기 접근 하는지 몰르겠네 본인 들 믿는 신 당당하면 신천지 까고 전도 하세요 괜히 사람 속 여서 열 받게 하지말고 퉷	FALSE
신천지 원주 엄청나다 ㅜ 제발 신천지 들 정신차려라 ㅡ 당신 들 구원 해주는것은 신천지 아니다 ㅡ 전도 하려고 힘 빼지말고 돈 받치지말고 자기 자신 위해 살아라 그렇게 하니 좋으냐 평범하게 사는게 제일 힘든거다 ㅡ	FALSE
신천지 두 번 걸려 봤는데 저 것 들 숨쉬는거 빼고 전부 거짓말	FALSE
이만 희도 사기꾼 당신 사기꾼 잖아 이만 희하고 사기 쳤잖아 재산 당신 거 아니지 신자 들 피 빨아서 만든 재산 국가 내어 놔야 맞잖아	FALSE
제발 이만 희가 영생 한다는 환상 깨세요 신천지 이만 희 본성 이원 이런 사람 입니다	FALSE
돈 내 목사 들 전부 사이비 예수님 돈 내 한 적 있니 아니면 교회 돈 갖다 주 한 적 있어	FALSE
신천지 한국 기독교 주요 교단 이단 결의 된 곳 입니다	FALSE
저런 저런 저 분 저러다 자살 당하시겠다 몸 조심 하셔야 될듯 예전 저런 사이비 종교 빠져서 나오려고 몸부림 치다가 행방불명 되거나 자살 당한 사람 많음 살해 자살	FALSE
제 신랑 여기 미쳐서 직장 가정 내 팽 개 저 거짓말 하며 가정 파탄 몰고가고 있습니다 제발 무너지길 바랍니다	FALSE
저런 싸이 비 왜 믿는 건지 사람 신 될수 없음 정신 들 차리세요	FALSE
하나 의 교회 안산 홍도 신천지 이단 입니다 안산 홍 재림 예수 속 있습니다	FALSE
이만 희 얼궄봐 완전 귀신 들린 얼굴 저 재림예수	FALSE
신천지 사람 들 옷 맞춰 입고 남자 들 넥타이 무조건 초록색 입고 간다 그거 볼때 진짜 겉 멀쩡해 보이는 대 부터 대 사람 들 나이 구분 없이 가는거 보면 정말 너무 신기했다 제 정신 아닌 사람 들 이렇게 많나 하고	FALSE
저 분 신변 보호 해야 할듯 사람 죽이는것도 별거 아닌 사이비종교 들 그 들 교주 위해 살인 하고 자살 한다 천국 간다 속 있으니 시키는대로 다 하 거든 그런데 진심 자아 게 없는거야 나도 종교인 종교 나 평화 얻기 위해 다니는거지 그 들 나를 바치 기 위해 다니는게 아니잖아 전 재산 요구 하면 이 거 뭔가 이상하다 이런 생각 안 들어 어떠한 종교 나 무언가 바라면 그때 그건 걸러 되는거야 어린 학생 들 특히 신천지 통일교 등 잡다한 이단 들 잘 해주는건 너 뺏을게 많아 서야 부모님 너 이유 없이 잘하주는 사람 없어	FALSE
청년 들 상대로 전도 한다고 하는데 절대 속 지 맙시	FALSE
신천지 이만 희를 믿는다는것은 자기 바보 란걸 증 하는거다 신천지 주말 헌금 할 돈 있으면 그 돈 가족 외식 해 그럼 가족 화목 천국 갈수 있는 지름길	FALSE
이런 것 공익 제 보라 하 틀린말은 아닌것 같은데이만 희 엄벌 처 해지 길 공범 김남희 엄벌 처 해지길 사이비 교주 인자 환상 커플 일세 푸하	FALSE
저기 겁나 웃김 무슨 지 들 끼리 단체 모임 하 다 큰 성인 들 기저귀 차고 참석 한다 함 이유 화장실 못 가게 해서 이런 정신 나간 짓거리 하는데에 몸 왜 담어	FALSE
윤석열 검찰 저런것을 수 사안 뭐 있나	FALSE
김남희 씨 지금 신천지 실체 널리 알려주세요 제발 부탁드립니다	TRUE
무료 타로 배우는거 나눔 한다고 친해지면 신천지 사무실 유인 하는것두 들었네요 ‥ 힘들 때 세상 친절하게 접근 하는 사람 들 다시 한번 생각 해보고 따라가세요	FALSE
신천지 신도 신안 염전 노예 다를게 뭐 있냐	FALSE
이만 희 죽고나면 신천지 볼 하겠네 신인 줄 알았는데 신 갑자기 죽어 버렸으니 얼마나 황당 스러울까 ㅋㅋㅋㅋ 진짜 모 지랭 들 모 개그 찍어라 주말 우리동네 유치원 생 들 까만 바지 치마 하얀 티 입고 교복 맞추고 모여있던데 정신 들 챙겨라 이 것 들	FALSE
욕 하는 댓글 러 들 다 신천지 족속 들	FALSE
어쩐지 늙고 돈 없는 노인 들 는 돈 없으면 나가라 그러고 전도 못 하면 내 어쩌 하더니 죽 때 되니 막바지 긁어서 모아 놓을려고 그랬던 거구 그것 모르고 신천지 다니는 사람 들 천 국가 쓸 돈 어쩌 하며 있는 돈 없는 돈 끌어다 받쳤구만 ㅉㅉㅉ	FALSE
종교 믿음 마음 힘들고 지 칠 때 안식처 되어 주거 봉사 싶은 사람 들 주위 돌보며 헌신 하는 역할 되 기를 바란다 막 살며 가식 떠는 인간 가정 잘 못 하는 인간 들 명예 생각 해서 장로 되려는 인간 들 모두 집 쉬시길	FALSE
이런거 믿는 사람 들 왜 믿는걸 까 그렇게 분별 력 없는걸 까	FALSE
문재인 이만 희나	FALSE
아니 상식 적 육체 영생 믿는다고 이만 희가 메시아 저걸 진짜 믿어 세기 아프리카 오지 아니고 it 강국 대한민국 진짜 이해 안되는 인간 들 ㅉㅉㅉ	FALSE
맘 카페 알 된 사람 통해 알 된 신천지 ㅎㅎ 처음 친해지는 척 하더니 교육 면서 속 감추고 하더니 결국 신천지 다 알아서 그만두고 연락 끊고 맘 카페 탈퇴 함 ㅎㅎ 참 멀쩡하게 생겨 갖고 왜 그런 짓 하는지 궁금하다	FALSE
신천지 사이 비교 진짜 미친거 같음 요즘 전농동 사거리 쪽 청량리 많이 보이더라 그리고 전단지 주고 그러던데 ㅋㅋ 내 친구 전단지 주는 사람 이 거 사이비 아니 하니까 눈빛 돌변 하면서 말 그렇게 하는거 아니라고 한 거 생각나네 ㅋㅋ 사이 비교 이제 왜 대놓고 나오니 드러운것 들	FALSE
신천지 장애인 고령자 포교 대상 제외 입니다 반 인권 적 종교 사기꾼 이	FALSE
여러분 전도 무교인 사람 전도 시키지 신천지 교인 전도 시키지 않습니다 교회 다닌다고 하는데도 좋은 말씀 어쩌 저쩌 하는 사람 무조건 신천지 번거롭게 말 걸면 걍 교회 다닌다고 하시고 피 하세요 신앙 생활 하지 않을꺼라면 이 단교 꼭 피 하셔 야합니다	FALSE
신천지 신도 들 어쩌 이단 아니 라드 교주 섬기고 있었네	FALSE
신천지 믿는 인간 들 지능 검사 좀 받아 봐라	FALSE
썩을 것 꼬득 사람 인생 망치 그러고도 인간	FALSE
신천지 뿐 그렇냐 모든 종교 단체 우상 돈 이지 부처 예수 얼굴 마 담이지요	FALSE
남편 자식 다 버리고 간 주제 말 많네 피해자 코스프레 하지 인자 못 된 짓 많이 했으니 각오 해야지	FALSE
너 신천지	FALSE
불법 거짓 포교 좀 못 하게 해주세요 설문지 무료 강의 경품 추첨 길거리 다니지를 못 하겠어 진짜	FALSE
한국 자칭 하나님 예수님 정도 계시던데 공통점 돈 여자 좋아한다는것과 코로나 같은 바이 러하 치료 못 해서 마스크 꼭 쓰고 다니신 다는것	FALSE
만민 교회 이재록 목사 본인 마지막 때 구원 섭리 이루는 성령 했고 남아 있는 성도 들 아직도 그걸 믿고 있어요 만민 교회 이단 절대 가지 다니는 사람 나오라고 말리세요	FALSE
친구 집 화곡동 인데 화곡역 쪽 교회 큰 건물 신천지 건물 데 젊은 남 여 어린 학생 들 너댓 명 씩 무리지어 다니더라구요 자기 들 딴에는 잘 차려입었다고 다니겠지만 싼 티나 정장 신발 가방 보기 딱합 디다 성 여성 분들 특히 많고 흰 상의 검은 바지 스커트 들 사는게 아무리 힘들고 고 되도 사이비 아니지 않나요 차라리 성당 나가든 교회 가지 우 째 없는 돈 더 알 겨내는 사이비 빠지노 무리지어 다니는 젊은 대딩 아 짐 들 볼때 쯔쯔 혀 차게 되드라구	FALSE
신천지 모름	TRUE
하나님 교회 안상홍 믿는다 웃김	FALSE
애효 신천지 문 천 지나 불쌍한 사람 들 ㅉㅉ	FALSE
신천지 성도 여러분 회심 하여 살아계신 예수 믿으세요	FALSE
결국 당신 신천지 잖아요 두 아이 엄마 남편 있으 신분 똥 오줌 못 가리고 이만 희한 테 당했다고 보기 당신 돈 명분 필요하니 이제 서야 폭로 하는건 뭐임 가족 부끄럽지도 않으신 가요	FALSE
유병언 경북 대구 이만 희도 경북 청도 일 베넘 들 고향 물 늘어지지 않는 이유 있었네 뒷 통수 누가 친다고 이만 희는 한센병 보균자 하네 이건 한세대 건너 발현 하기 때문 친자 없는거였어	FALSE
사이비 줄 알고있었지만 김남희 알고도 불륜 저지르고 가족 파탄 내고같이 혹세 무민 하 다가 이제 돈 욕심 이제 서 폭로 하냐 다 끝 수사 하 야한다	FALSE
전반 적 수사 들어가야 한다 대형 사기 국가 가만히 있으면 안된다 어마어마한 법죄 사기 꼬리 꼬리 물 나올것이다	FALSE
도 찐 개 찐 함께 하나님 팔 사람 들 함께 사기 쳐놓고 지옥 따놓은 당상 신천지 젊은 청년 드 어 짜 끄나 쯧쯧 쯧쯧	FALSE
신천지 헌신 하느라 허송 세월 보내고 가족 들 멀어진 사람 들 인생 어찌 하나요 ㅠㅠ 그 들 인생 어떻게 돌릴까 요 ㅠㅠ	FALSE
탈 종교 대세 호모 데 우스 시대 사이비 모든 종교 법인세 부가 및 국세청 검열 받아 야함	FALSE
이만 희는 사기꾼 사기꾼 제발 속지 말라 정신 차리자	FALSE
신천지 하나님의교회 통일교 구원파 여호와 증인 다 사이비 입니다 절대 가지 마세요 일반 교회 아닙니다	FALSE
이렇게 폭로 된 김 신천지 잘 못 된 교회 게 전국 적 확산 되어서 사회 적 문제 거론 되어 해체 시키는 방법 나왔으면 좋겠다 너무나 많은 선량한 사람 들 꼬임 빠져 허우적거리고 있으며 내 아들 대학 포기 지금 아예 대화 않고 하루하루 너무 고통스런 날 보내고있다 신천지 제발 다 벗겨지길	FALSE
우리나라 제대로 된 종교 아닌 사이비 없어지게 했으면 좋겠습니다 저 제 가족 중 한 명 신천지 아니고 사이비 빠졌는데 맨날 헛소리 해대 정말 죽 맛 입니다	FALSE
이해 합니다 ㅎㅎㅎ	TRUE
허경영 교 믿는 사람 늘어 갑니다 매달 씩 받으려고 우리 세 식구 인데	FALSE
인간 신격화 대 깨뭉 들 똑같은 수준	FALSE
신천지 교주 이만 희의 마각 밝혀지고 있습니다 결혼 해서 아내 있으면서 남편 있는 김남희 성관계 맺는 자체 마귀 짓이죠 계시록 장 절 음행 하는 자가 둘째 사망 불못에 던져진다고 했는데 이만 희가 둘째 사망 불못에 떨어집니다 여기 예수님 너희 하나님 재물 겸 하여 섬길수 없다고 하셨고 마 장 절 가난하게 사셨는데 교회 담임 지 파장 자리 미끼 돈 착복 신도 들 속 헌금 하게 하고 부를 축적 했습니다 성경 부자 천국 가기 심히 어렵고 누가복음 장 부자 지옥 갔다고 했는데 ㅡ 답글	FALSE
이만 희가 가장 뜨거운 지옥 가겠군요 그리고 새 하늘 새 땅 장차 이루어질 것 한국 이미 신천지 새 하늘 새 땅 가 도래 했다고 속 여러 나라 이사야서 선지 서에 재물 가지 새 예루살렘 올것을 말 한 것 그것 장차 이루어질 일 이 것 지금 자기 들 적용 해서 이루어진다고 거짓말 해서 신도 들 모았습니다 황당한 짓이죠 이렇게 성경 잘못 해석 해서 자기 들 중심 풀 이런 무서운 이단 되는 것 입니다 그리고 이만 희가 죽어서 육신 부활 한다는 것 새 빨 간 거짓말 이 이린 것 믿고 신천지 신자 되는	FALSE
자 들 이만 희와 똑 같습니다 이 들 갈 곳 지옥 입니다 이제 신천지 이만 희의 정체 드러나고 있으니 신천지 있는 자 들 거기 빠져 나와서 죄 회개 구세주 예수님 십자가 보혈 죄 용서 함 받고 거듭 나야 합니다 그렇지 않으면 지옥 갈수 없죠 우리 성경 진리 바로 알아야 되고 시대 적 잘 적용 해야 합니다 예수님 오시 기전 구약 성경 이스라엘 중심 쓰여졌고 율법 시대 입니다 그리고 이사야서 등 많은 예언 구세주 예수님 오실것을 예언 했고 또 장차 있을 천년왕국 천국 대해 예언 했습니다	FALSE
그것 이 세상 종말 심판 있고 그 후 되어질 일이 이 것 신천지 같은 이단 들 지금 자기 들 적용 해서 이단 되고 사회 물의 일으킴니다 그리고 지금 신약 시대 예수님 전 오시 신약 교회 세워진 때 지금 이어지고 있죠 이 것 교회 시대 우리 예수님 사도 들 본을 따라야 합니다 예수님 가난하게 사셨고 사도 들 모든 소유 버리고 주 쫓았다고 했으면 우리 이렇게 살아야 합니다 그리고 천국 소망 하며 하나님 의 나라 먼저 구 의 거룩한 삶 살아야죠	FALSE
물질 세상 복 구 하는 것 아니라 영적 신령 복 구 경건한 삶 살아아죠 그러면 우리 이 땅 떠나면 신천지 즉 천년왕국 천국 영원히 복 받습니다 물론 영생 누리 사람 들 이런 이단 쉽게 넘어가는 것 너무나 인따 깝습니 이 책임 교회 있죠 이 들 많은 사람 들 재물 돈 세상 복 추구 도덕 적 삶 세상 별반 다를 바 없고 천국 대한 확실한 소망 없기에 이단 생겨날수 없습니다 교회 많은 가라지 지옥 갑니다 가라지 거두어 불 사르는 것 같이 세상 끝	FALSE
그러하리라 인자 예수님 가 그 천사 들 보내리니 그 들 그 나라 모든 넘어지게 하는 것 불법 행 하는 자 들 거두어 내어 풀무 불 던져 넣으 리리 거기 울며 이를 갈게 되리라 그 때 의인 들 자기 아버지 나라 해와 같이 빛나리라 귀 있는 자는 들으라 마 장 절 고 했죠 그리고 손 키 들고 타작 마당 정 하게 하사 알곡 곳간 천국 들이고 쭉정이 꺼지지 않는 불 지옥 태우시리라 마 장 절 고 했습니다 이외 가라지 즉 거짓 신자 들 대한 경고 많이 있습니다 이렇게 이단 가짜 많다는	FALSE
것 참된 진리 있다는 것 입니다 우리 살 계시는 전능하신 하나님 믿고 구세주 예수님 십자가 대속 피로 죄 용서 함 받고 거듭 나서 하나님 자녀 되고 말씀 순종 해야 합니다 말씀 안 모든 것 다 있습니다 말씀 외 더하거나 말씀 빼면 잘 못 된 길 가죠 우리 예수님 안 있을 때 참된 진리 알 되고 예수님 주시 참된 평안 기쁨 자유 쉼을 얻고 사랑 희락 화평 오래 참 음 자비 양 선 충성 온유 절 재의 성령님 열매 맺고 겸손하고 온유 하시며 은혜 우신 예수님 닮고 따르며 받은바	FALSE
은사 하나님 일 하고 영적 열매 맺고 말씀 순종 함 하나님 약속 하신 참된 복 받고 이 땅 떠나면 천년왕국 천국 영원무궁 복 받습니다 신천지 외 이단 여호와 증인 하나님 교회 안식교 통일교 몰몬교 등 있습니다 ● 이단 속 사람 한두 번 훈계 후 멀리 하 이러한 사람 네 아는 바 같이 스스로 정죄 자로 죄 짓느니라 디도서 장 절 ● 악한 자의 나타남 사탄 활동 따라 모든 능력 표적 거짓 기적 불의 속임으로 멸망하는 자 들 있으리니 이는	FALSE
그 들 진리 사랑 받지 아니하여 구 원함 받지 못 함이라 이러므로 하나님 미혹 역사 그 들 보내사 거짓 것 믿게 하 심은 진리 믿지 않고 불의 좋아 하는 모든 자 들 하여금 심판 받게 하려 하 심 살후 장 절 ● 아름다운 열매 맺지 아니하는 나무 찍혀 불 던져지느니라 이러므로 그 들 열매 그 들 알리 나 예수님 주 주 하는 자 다 천국 들어갈 것 아니요 다만 하늘 계신 내 아버지 뜻대로 행 하는 자라야 들어가리라 그 날 많은 사람 나 이르되 주 주 우리 주의	FALSE
이름 선지자 노릇 하며 주의 이름 귀신 쫒아내며 주의 이름 많은 권능 행 하지 아니하였나이까 하리 그 때 내 그 들 밝히 말하되 내 너희 도무지 알 못 하니 불법 행 하는 자 들 내게서 떠나 가라 하리 마 장 절 ● 좁은 문 들어가라 멸망 인도 하는 문 크고 그 길이 넓어 찾는 자가 많고 생명 인도 하는 문 좁고 길이 협 착하여 찾는 자가 적음 인사 마 장 절 ● 너 진리 말씀 옳게 분별 하며 부끄러울 것 없는 일꾼 인정 된 자로 자신 하나님 앞 드리 기를 힘쓰라	FALSE
디모데후서 장 절 ● 그러나 우리 시민권 하늘 잏 ㅇ 는지라 거기 로부터 구원 하는자 곧 예수 그리스도 기다리노니 그 만물 자기 복종 하게 하실 수 있는 자의 역사 우리 낮은 몸 자기 영광 몸 형체 같이 변하게 하시리라 빌립보서 장 절	FALSE
심각한 사람 한 명더 추가	FALSE
신천지 사람 들 앵무새 거기 하는 말 듣고 말 하지말고 김남희 말 원본 영상 한번 찾아서 들어 보세요 그걸 언제 저건 악의 적 편집 거짓말 할건 가요 신천지 얼마나 고발 달인인데요 거짓말 이면 저렇게 나와서 증거 들이밀지도 못 해요 여러분 들 두려워 하지말고 들어 보시 지금 깨 달으시길	FALSE
유병언 이만 희는 지금 지옥 서로 본인 들 교주 쌈 박질 하고 있을거다 무지한 신자 들의 영혼 탈탈 털고 돈 털고 가정 박살 내고 불륜 저지르고 나쁜 짓 일 삼 았 범죄 소굴 수장 유병언 ㆍ 이만 희가 지옥 안 가면 누가 간단 말 김남희 공범 이군 남 희 너 지옥 행 돈 때문 불륜 다 까발리는구나 이런 사이비 종교 목숨 거 종자 들 개 ㆍ 돼지 사 람 이 라면 판단 있어야지 믿을걸 믿어라	FALSE
청평 건드리지마라 내 시댁 있는 동네 봉사활동 이 랍시고 주말 평일 조끼 입고 설쳐 대는 것 들 천당 니 들 가세 멀쩡한 동네 종말 부르지말고 썩 물러가라 이단 들 역겹다	FALSE
신천지 사이비 이야기 전부터 전부터 들은 이야기	TRUE
하루빨리 더러운 양 옷 벗고 실체 드러나야 한다 생각 합니다 한 낫 개인 정욕 물욕 채우기 위해 얼마나 많은 가정 파괴 되었는지 신천지 교주 그 밑 수하 들 적어도 미안함과 죄책감 느껴 야합니다 아닌 걸 알면서도 자신 위치 권세 잃는게 두려워 순진한 사람 들 웃으며 양 탈 쓰고 밟았습니다 지금 양 신 선언 한 당신 용기 박수 드립니다 그리고 신변 보호 경찰 요구 하셔 야할거에요 ㅠㅠㅠ	FALSE
김남희 당신 어떤 죄악 저질렀는지 알거 아시 변명 하지 당신 지식 용서 구 하시구려 동거 할 때	FALSE
뭘 놀라냐 종교 원래 다 사기 사기 쳐야 사람 들 정말 그런줄 알 믿지 정말 죽으면 천 국가 줄 아냐 ㅎㅎ 하늘 어디 가는데 ㅎㅎ 주소 얘기 해줘 봐 ㅋㅋ 하늘 가면 누구 있는데 엉 그리고 하늘 가서 뭐 하는데 엉 밥 어떻게 먹고 살 그리고 거기 무슨 재미 사는데 엉 ㅎㅎ 말 안되는 아직도 이런 걸 믿고 있는 사람 들 있네 인간 포함 이 지구 상의 모든 생명체 죽으면 그것 끝 The end 소나 돼지 죽으면 소고기 돼지고기 인간 밥 되는거야	FALSE
파리 모기 죽으면 끝 식물 죽으면 끝 인간 죽으면 그 걸 끝 그런데 영혼 살아나서 하늘나라 간다 ㅋㅋ 그렇게 믿고 싶은거겠지 그랬으면 좋겠다는거겠지 그리고 죽지 않고 영원히 산다 ㅎㅎ 인류 역사 수 천년 이래로 정말 그런 사람 단 한 사람 있었어 ㅎㅎ 희망사항 겠지 그 희망 이용 해 사기치는게 종교 전지전능한 신은 그걸 가능하게 할수 있는것처럼 얘기 해서 믿게 만드는거지 목사 신부 종교 고위 자 이 다 뻥 다 알 있지 지네 들 먹고 살기 위해 선	FALSE
신도 들 정말 그럴듯하게 얘기 해야 믿지 않겠어 헌금 들어오고 우리 알 있는 성경 코란 불교경전 공자 맹자 이런 것 다 뻥 알 있지 그럴듯하게 얘기 해서 믿게 만드는 ㅎㅎ 인간 좋은 건 다 그렇게 되었으면 하는 바램 있지 그렇게 되고 싶고 그렇게 되었으면 하는 믿음 그걸 이용 하는게 종교 신 믿으면 그게 다 가능할것처럼 하는 그렇게 믿고 살아야 마음 편하니까 나 이 신 믿으면 정말 이 신 나를 구원 해줘서 나 죽지 않고 영원히 살수 있어 아니 설령 죽더라도 이 신	FALSE
나를 부활 시켜 나를 천국 영원히 살 해줄거야 아님 나중 아마겟돈 전쟁 때 악 다 없어지고 의 사람 들 남았을 때 그때 신 나를 부활 시켜 신세계 영원히 살 해줄거야 믿음 ㅎㅎ 그런 심리 이용 해 믿게 만드는게 바로 종교 그거 해줄테니까 나 믿어라 이 거 아닌가 ㅋㅋ 거기 빠져 시간 노력 돈 낭비하지 정신 차리고 살	FALSE
부인 밥 해주는 할머니 하다니 그 부인 얼굴 봤었는데 불쌍타 이만 희 실제 보면 피부관리 돈 많이 쓰는 할아버지 목소리 힘 없이 모 기 소리 하다 이만 희 교리 보면 얼마나 기 찬 사기꾼 줄 안다 그래서 의심 많이 했는데 의심 안 하는 애 들 멍청해도 넘 멍청함	FALSE
이제 모두 신천지 늪 나오시지요	FALSE
개신교 이단 사이비 집단 들 말 예수 믿는다는 것 들 온갖 사회 비리는 다 저지르고 한기총 회장 인간 하나님 까불면 지 한 테 죽는단다 이 종교 마귀 집단	FALSE
과천 꺼져 진짜 수요일 일요일 되면 흰 티 검정 바지 입은 것 들 바퀴벌레 떼져 오는데 진짜 소름 돋음 수요일 일요일 절대 흰 옷 검정 바지 안 입는다 니 들 때문 이마트 스벅 맥날 주변 식당가 등등 니 네 죽 있어서 주민 들 불편해	FALSE
말세 거짓 선지자 많다고 성경 기록 되어 있는데 안타깝네요 아무 알아주지 않지만 천국 소망 가지 묵묵히 자 기일 하는 목사 님 계신데 다 저런것만은 아닙니다 믿는 사람 들 흔들리지 마십시오 늘 범사 감사하고 나라 위해 기 도합 시	FALSE
종교 사람 들 행복하게 만들기 위 한 것 신천지 무엇 위 종교	FALSE
ㅋㅋㅋㅋㅋㅋㅋㅋㅋㅋㅋㅋ 저걸 믿는것 들이나 저렇게 속 있는 놈 ㅋㅋㅋㅋㅋㅋㅋㅋㅋㅋㅋ	FALSE
진짜 조금 더 일찍 나와서 다행 요 같이 나가자고 했던 동기 들 이 거 보고 제발 나왔으면 합니다 그래도 신천지 온갖 ㄱㅓ 짓 말로 또 성도 들 붙잡고있겠지 ㅠㅜ 안타깝다	FALSE
신천지 뿐 아닙니다 세 광 중앙 교회 김 노아 목사 똑같은 사람 청년 들 성폭력 성추행 등 돈 목적 한 종교 사기꾼 입니다 신천지 똑같은 이름 전국 활동 있지만 세 광 중앙 교회 전 새 빛 교회 전국 있는 몇 백 개 네트워크 교회 이름 바꿔 활동 있어 더 무서운 집단 입니다 제발 정신 좀 차리세요	FALSE
하나님 외 다른 신의 존재 믿거나 교주 자신 하나님 섬기라는 것 들 무조건 이 단 임 이 거 하나 똑바로 알 저런데 가입 할 일 없다 저런데는 종교 단어 붙이기도 아깝고 저런데에 빠져서 헤어 나지 못 하는 사람 들 보면 진짜 불쌍함	FALSE
심리상담 해준다고 접근 해서 성경공부 무료 해준다고 개월 과정 성경 아카데미 학원 꾸며놓고 사람 들 포섭 하는거 유명하죠	FALSE
사이비종교 대한 특검 했으면	FALSE
종교 가다 썩엇다 왜 기독교 그럴까 어떤자는 또 하나님 나 까불면 죽어 하는 목사 잇는 가하면 이 성도 들 할 짖인가 진정 하나님 있는걸 까 목사 것 들 돈 제멋대로 쓰고 지가 하나님 세상 썩은 세상	FALSE
하느님 믿는다면서 개독 신천지 내 눈 둘다 사탄 들 드글드글 하던데 개척 교회 목사 신도 들 따먹다 걸려서 다른 지방 전출 가질 않나 신도 들 투 자금 끌 들어 땅 투기 하질 않나 장로 들 십일조 안내 바람 피우다 걸려서 마누라 쫓겨나질 않나 신천지 문제 개독교 문제 참 많음	FALSE
그런다고 이제 니 년 죄 없어지겠니 니 년 보고 여 직껏 재산 갖다 바친 사람 공범 년 이제 서	FALSE
머냐 이건 뻔해 보이냐 니 들 대 깨문도 똑같이 세뇌 당하고있는건 디 대 깨문 탈출 지능 순이 진심	FALSE
이건 뭐 사기꾼 이 걸 믿고 따르는 자 들 있다니	FALSE
돈내 몸 달라 둘 중 하나 요구 해도 거 긴 순수한 종교 집단 아니다 장사꾼 들 사기꾼	FALSE
김밥천국 신천지 것 더러워서 안 먹어야지	FALSE
종교 무슨 걍 미친거지	FALSE
전광훈 이 목사 해처 먹는 나라	FALSE
신천지 얼마나 무식한 사람 뇌피셜 면 예 들어 삼위일체 란 tri nity 의 번역 즉 세 인격 체 하나 다라 뜻 즉 일체 것 하다 라라 의미 번역 것 뿐 이 이만 희 영감 일체 한 몸 의미 그래서 성부 성자 성령 삼위 어떤 사람 한 몸 임 했는데 그게 자기 ㅋㅋㅋ 그래서 자기 안 죽는다는거야 ㅋㅋ 일체 말 이런 뜻 이 라면 주류 일체 음식점 써있으면 술 종류 한 몸 임 하는 것 말 하냐 어이 없어요 그러니 기독교 계 이 들 주장 것 아예 신 학적 검토 할 의미 가치 없을 정도	FALSE
조잡하고 조악해서 이건 그냥 하나 열 가지 엉터리 뭐 따지고 뭐 할 것 자체 없다라고 하는거야	FALSE
이만 희 몸 임 했는지 누구 임 했는지를 떠나서 일체 말 자체 누구 몸 임 한다는 뜻 자체 아니라고 ㅋㅋ 그냥 성부 성자 성령 삼위 하나 다라 뜻 아무튼 이 신천지 주장 국어 자체 이해 못 하는 주장	FALSE
그럼 또 신천지 회원 자신 들 왜 안 죽는다고 생각 하느냐 이 것 이만 희가 계시록 문장 자체 엉뚱하게 이해 해서 그래 이건 성경 조금 오해 하기 쉽게 번역 되어 있는데 그럼 영어 원래 기록 된 언어 헬라어 참조 해야 할거 아니야 근데 이만 희는 영어 못 해 ㅋㅋㅋ 그러니 좀 오해 소지 있게 번역 된 구절 지 편한대로 멋대로 이해 했어 ㅋㅋㅋ 신 학적 나발 이 고간 문장 자체 엉뚱하게 이해 결과 ㅋㅋ 이 걸 믿어 이만 희는 노인 그렇다 신천지 사람 들 영어 할줄 아는 사람 한 명도 없어 ㅋㅋㅋ	FALSE
그럼 여기 서는 뭐라고 하는줄 아냐 이만 희가 재림주 이만 희가 한국 사람 한국어 성경 오히려 옳다는거야 ㅋㅋㅋ 원래 언어 헬라어 틀렸고 영어 틀렸고 한국어 번역 된 것 옳데 ㅋㅋ 무슨 이런 ㅋㅋ 이건 한 마다 누가 공자 논어 한국말 잘못 번역 해놨는데 한국어 논어 옳고 한문 원래 쓰여진 논어 틀렸다라는 소리 이 무슨 말 같지도 않은 이야기	FALSE
그냥 나이 먹은 불륜 남녀 둘 사 기 행각 돈 갖다 바치 가정 파괴 하면서 놀아나는 어리석은 사람 들 뿐 다 사기 당하는 것 들 사기꾼 문제 사기 당하는 것 들 그 들 스스로 탐욕 있으니 당하는거야 그러니 신천지 회원 들 스스로 탐욕 어리석음 때문 그딴 조악한 사기 넘어가는거	FALSE
이런 말 하면 분해가지고 두 고 보라 거 다 죽는데 자기 네 산다 이거지 뭔 순교자 영 자기 임해 자기 들 영생 한 다나 그날 오면 우린 다 죽는데 자기 들 다 산다 거 그때 두고 보자 이러면서 씩씩거린다니까 ㅋㅋㅋ	FALSE
자기 들 숫자 명 차면 그 날 온데요 우린 다 죽는데 ㅋㅋ 근데 이 명 숫자 성경 나오긴 하는데 이 것 또 지 멋대로 성경 유대인 했어 이 걸 이해 하는 방식 두 가지 있어 원래 성경 문자 적 이해 하는 것 원칙 그러니 둘다 문자 적 이해해 말그댜 유대인 들 진짜 숫자 그대로 명 선택 된다고 이해 하는 견해 있어 이 걸 전 천년 주의 해 정당한 해석 문법 적 역사 적 해석 하는게 성 경 해석학 원칙 반면 유대인 단어 숫자	FALSE
도 둘다 상징 이해 하는 견해 있어 무 천년 주의 적 해석 유대인 성도 은 무한 수 즉 무한 수의 성도 이해 하지 이 것 정당한 해석 우 로나 장로교 주로 이렇게 해석 으 를 해 이 들 성 경 해석 원리 문자 적 역사 적 해석 원칙 계시록 묵시 문학 특성 상 상징 적 해석 원칙 거 다 해석학 적 근거 명확하기 때문 둘다 정당한 해석 이괴 서로 존중 해요	FALSE
근데 이 신천지 유대인 단어 이건 자기 들 은 슷자 그대 무순 이런 지 편한대로 갖다 붙이는 해석 다 있나 한 구절 어떤건 지 편한대로 유대인 아니라 자기 들 하고 그럼 이건 상징 이해 하는거야 그럼 다음 도 상징 이해 하던가 숫자 또 숫자 그대로 뭔 이런 코 걸면 코걸이 귀 걸면 귀걸이 다 있어	FALSE
숫자 숫자 그대로 할거면 침례교 전 천년 주의 유대인 혈통 상의 유대인 해야 하는거고 유대인 혈통 상의 유대인 아니라 성도 상징 적 해석 할거면 장로교 무 천년 설 숫자 도 상징 적 해석 해야 하는거야 한 문장 이건 사실 적 저건 상징 적 마구 편한대로 갖다 붙이 성경 그런 식 지 편한대로 해석 하면 성경 자고 별별 이론 다 만들어 낼수 잇다 공산주의 자 예수 만들수 있고 동성애자 예수 만들수 있지 암튼 신천지 아예 학문 적 논 할 가치 없는 잡설	FALSE
예 들 혈통 적 유대인 사라졌으니 더 이상 찾을 수가 없어서 그렇데 아니 신 존재 한다면 그 신은 전능한 존재 혈통 적 유대인 명도 못 남긴다는거야 그럼 전능한 신 아니지 그럼 전능 자도 아닌데 뭐 하러 믿나 그것 못 믿으면 데 하지되 빼지되 않고 명도 아니고 명도 아니고 딱 맞춰서 명의 숫자 마주 추는 신이라면 당연히 혈통 적 유대인 남길 수가 있는거고 아니면 즉 유대인 이 젠 의미 없고 다른 무리 즉 성도 상징 적 지칭 한다고 이해 하려면 숫자 역시 상징 적	FALSE
이해해 장로교 일부 무 천년 설 무한 히 많으느 성도 이해 하던가 유대인 부분 장로교 무 천년 설 따오고 은 침례교 전천년설 따와서 자기 들 편한대로 갖다 붙이는 이런 짜집기 해석학 원리 뫄르 영감 궤변 속 는 사람 들 한 삼한 거지	TRUE
이 거 신천지 회원 들 좀 읽어라 내 이 적어놓은 것 알 아들 어도 신천지 나올수가 있다 ㅡ 근데 이만 희는 또 여기 도망 못 가는 장치 해놨어 교활한 노인 네 성경 짐승 표란 있어 지금 내 한 이 말 듣고 그 런가 아닌가 따져 보는 것 짐승 표 받는거래 그럼 죽는데 그러니 귀 막 필사 적 내 위 하는 말 아예 듣지도 말라는거야	FALSE
즉 현재 바로 종말 환란 기이 짐승 표 받지 않고 버텨야 살아남는 그 절박 시대 거 이 노인 네 무식하긴 하면서도 정말 사람 심리 잘 파악 해서 어떻 게 하 두려움 줘서 심리 적 묶어놓을 른 지를 기 막히게 파악 아예 뭐 틀렸는지를 말 해줘도 듣기 거부 하게 만들어놨어	FALSE
성경 볼라 헬라어 그때 그 언어 보는게 진짜	TRUE
당신 이만 희 욕 할 처지는 아닌것 같은데	FALSE
두 아이 엄마 였고 남편 있던 여자 자랑 ㅉㅉ 이 젠 돈 때문 부끄러운것도 모르고 참 얼굴 두껍네 ㅋㅋ	FALSE
어떻게 저런 이단 빠질까 진짜 신기함	FALSE
김남희 당신 전 남편 아들 먼저 불쌍하네요 남편 배신 그렇게 어리석은 당신 원망하길	FALSE
이제 서라도 폭로 했으니 다행 생각 드 네 저 사람 폭로 안 했으면 지금 쯤 몇 천명 몇 만 명 거기 끌려 갔을테니	FALSE
저기 ㅋㅋ 저 교주 사기꾼 신천지 신도 빼고 다 알아요 딱히 폭로 랄 내용 없는데 ㅋㅋ	FALSE
정신병 자 들이 너무 많구나 차라리 닭 똥구멍 믿어라 하루 계란 하나 씩 나온다	FALSE
인간 스스로 만든 우상 무너지게 마련 입니다 인간 영적 존재 이기 악한 마귀 미혹 영 통해 유혹 하죠 왜 구 지옥 끌 내려가야 하니 깐요 재림예수 오시 혼자 가야 하니 외롭지 않겠어요	FALSE
정신 나간 사람 들 사기꾼 들 몸 주고 돈 갖다 바치 뭔 짓 들이냐	FALSE
이단 들 특색 여 신도 들 매개 성의 노예 종속 시킨 뒤 자신 신격화 시켜 영적 이 들 지배 하여 조직 키워 자기 욕심 채웠다 이 들 종교 집단 아닌 범죄 집단 들	FALSE
외모 사람 평가 하는거 잘못 된거 영 상속 사 람보 딱 봐도 인물 신체 사이즈 보행 장애 뭐 하나 보통 이하 저런 덜 떨어진 사람 세치혀에 훨씬 훌륭한 사람 들 현혹 되어 단체행동 하는것 보니 세상 꼭 불공평한것도 아닌듯	FALSE
다단계 있음	FALSE
신천지 댓글알바 들 다 어디 갔니 ㅋㅋㅋㅋㅋ 정신 들 좀 차리세요 대놓고 사기치는것 들 신천지 만민 이재록 정말 신기할 따름	FALSE
신천지 믿는 사람 들 이해 가안 간다 말 되는 소리 믿게끔 해야하는데 이 해안가 말 한다 생전 착한 짓을하면서 열심히 살 알아서 천 국가 못 되 게살 지옥 간다 이건 저 세상 어떻게 살았는지 다 보인다	FALSE
제발 신천지 나오세요 저런 사람 교주 믿는다니	FALSE
신천지 정치 늘 줄 대더라 박근혜 당 줄 대더니 이제 어디 대니 하나님 대통령 지정 해준다고 육포 힘내라고 하니 대학교 새내기 들 뭐 사주면 꼬 신다더니 심각하다 종교 세 과세 하자	FALSE
사기 날 강도 들 왜 누구 구속 시키지 않는 건지 ᆢ	FALSE
사이비 저능 아들	FALSE
코로나바이러스 방역 있는데도 사람 들 불러 모아 헌금 받는 전광훈 신천지 뭐 다르지 전광훈 이 김문수 또 박근혜 당 열렬한 신도 들 대구 경북 그 들 추종자 이번 에 선거 보면 알겠지 상식 선 판단 해도 사이비종교 추종자 들 그게 그거	FALSE
fbgo 이 나쁜 넘	FALSE
그건 모르겠지만 너 같은 놈 제일 나쁜 놈인건 안다	FALSE
니 제일 시러	FALSE
신 새 천지 누리	FALSE
이만 희를 하나님 믿는 사 럼 부처 신 믿는 사람 똑같다	FALSE
이런 종교 심취 하는 인간 들 보면 토착 왜구 수구 꼴통 악어 억 어 새 처럼 기생 하는 대한민국 의 정신 나간 얼치기 들 생각나지 왜 ㅎㅎ	FALSE
나라 꼴 이 모양 그렇습니다 지금 국민 들 선동 해서 이니도 대통령 하는 마당 저런 사이비 홀리 사람 들 이해도 갑니다	FALSE
신천지교 문슬람교	FALSE
CBS 도 진정한 기독교 방송 역할 못 한다	FALSE
아니 딱 봐도 사이비 봐도 모르나 왜 빠지는거야	FALSE
코로나 무서운 신천지 것 들	FALSE
대구 확 진자 신천지 던데	FALSE
집 찾아오는 사이비종교 일부러 들어오라고 하고 들어 본다 하나같이 똑 같은 결론 한국 신 선택 나라고 하나님 선택 받아 천국 된다고 ㅋㅋㅋ 그리고 교주 한 마리 씩 있음 어느 이단 여자 교주 어머니 하나님 다 ㅋㅋㅋ	FALSE
얼마나 불쌍한 인생 이면 저런 새끼 신 믿을까	FALSE
이만 희 사형 전광훈 무기징역	FALSE
한기총 사이비 같은데 하나님 까불면 전광훈 죽는다며	FALSE
신 어딨어 개독 그렇고 제발 너 자신 믿어라 평생 신 찾다가 ㅂ 신 된다	FALSE
쟤 들은 악질 중 악질 임 조폭 들 아니고 한번 발 들 이면 사람 감시 붙잡으러 다님	FALSE
신천지 다 뒤지세요 제발	FALSE
이번 기회 정부 사이비종교 교주 들 처벌 하는 법 신설 해야 합니다 사람 영혼 세뇌 시키고 교주 맹종 시키는 사이비종교 법적 처벌 할수있게 정부 여당 나서라 사이 비교 주 집단 통일교 신천지 하나님 교회 jms 등 많은 사이비 척결 해야 됩니다 법 제정 합시다	FALSE
뭔 정부 나서나요 박근혜 정권 구원파 신천지 붙었고 이 정권 여호와 증언 편 붙은 것 같은데	FALSE
언제 만민 애 미라 더니	FALSE
신천지 교주도 다른 사이비 다를게 없네요 이번 참에 미투 조사 받길 바랍니다	FALSE
믿는 인간 뇌 부족한거지	FALSE
신천지 명백한 사이비 아니 이 정도 사기 범죄	FALSE
육적 배필 뭐 서로 고기 비빈다는 애 긴가 어렵네	FALSE
풉 육적 배필 라면 한마디 물 받이	FALSE
대한민국 아무리 자유 민주주의 국가 라지 사이비 종교 법 금지 시켜야 되는거 아니냐	FALSE
저런 사이비 빠지는 사람 ㅡ 멍청이	FALSE
어떤 빡 대가리 가지 신천지 믿을 수 있는 걸까	FALSE
둘다 간통 사기꾼 들 나중 알고도 활동 해 놓고 이 교주 뒤집어 씌우려는 꽃뱀 수법	FALSE
뉴스 천지일보 나오면 클릭 하지말자 신천지 꺼	FALSE
문재인 저런 사이비 집단 단 속 좀해	FALSE
자 한 당 뿌리 들 이집 권할 때 생겨난거야	FALSE
이명 박근혜 돈 줘서 댓글알바 시켰지	FALSE
치료 필요한 이 들 이 밤 대 댓글 달며 세상 이분법 재단 있구나 낮 잠 자겠지	FALSE
난 저런 걸 믿는다는 사실 너무 신기해	FALSE
신천지 만세 상 실체 드러나는구나	FALSE
이단 끝 섹스 새 삼 스레 뭘	FALSE
신천지 역대 정부 왜 막지 못 했을까 의문	FALSE
우리엄마 돌려내라 사기꾼 들 ㅜㅜ	FALSE
아니 도대체 저딴 사이비 왜 믿는거 임 점 쟁이 점 보는거 이 것 이해 못 함 재미 보는건 이해 한 다지 맹신 적 점 믿는다던지 저딴 사이비 믿는다는건 도저히 내 상식 이해 할수 없음	FALSE
한번 세뇌 당하면 못 나옴 특히 여성 분들	FALSE
신천지 빠지는 인간 들 참 한심하고 멍청하다	FALSE
기자 이름 요셉	FALSE
일베 대 한 애국 당 이해 되것지 ㅡㅉㅉㅉ	FALSE
너 똑같은 신천지	FALSE
제발 남 들 이단 이라는데는 가지 마라 멀쩡한 종교 단체 많은데 왜 이단 데 빠지냐 돈 내지 받고 다녀라	FALSE
신천지 이단 절대 가지 마세요 Cbs 는 기독 좌파 아웃	FALSE
그럼 전괴 ㅡㅇㅅ 눈 믿으란 거 한심한 넘 같으니 어이없네	FALSE
사기꾼 들	FALSE
이단 속 서 지옥 가게 될 영혼 들 넘 불쌍하네요 신천지 이 모두 주님 품 돌아오게 된다면 얼마나 좋을까요	FALSE
저 것 들 수 사 못 하	FALSE
전광훈 이 수사 했으면 신성모독 둘째 빤 스타 령 ㅋㅋ 이런 것 넘어가는데 그 놈 종교 자유 누구 봐주고 누구 안 봐주고 그럼 형평성 어긋나죠	FALSE
교회 란 글자 사 영도 하지말 라그 거짓 사기꾼 집단 감옥 쳐 넣어야 한다	FALSE
이런데 빠지는 사람 들 불쌍	FALSE
왜 이런 사이비 종교 단체 안 없어질까 한번 제대로 정부 파헤치면 끝장 왜 정치 비호 받거든 왜 돈줄 돈줄 사이비 종교 단체 거대 다단계 사 업체 이 들 돈 풀어서 막아주는거야	FALSE
추미애 나중 자기 문재인 이의 육적 배필 이었다고 폭로	FALSE
추하다 너무 나갔어	FALSE
말 조 심하거라	FALSE
미친 해도 해도 너무하네 그렇게 살아서 뭐 하시려나 어처구니없네 거울 한 번 쳐다 봐 악마 추악한 얼굴	FALSE
다양하지요	TRUE
한나라당 새누리 자유 한국 당 새누리당 번역 하면 신천지 사이비 교주 최태민 딸 최 순 실 박근혜 한 태 새누리당 신천지 당 이름지어 준거 ㅎㄷㄷㄷ	FALSE
그걸 이제야 알았냐 신천지 뿐이겠냐 대부분 종교 자체 다 사기 다른 기독교 들 사기 아닌 줄 아냐 장로교 감리교 침례교 안식일교 몰몬교 여호와의증인 천주교 불교 원불교 등등 다 사기 모르냐 걔네 들 주장 하는거 그거 다 뻥 환상특급 현실 세게에서 절대 이뤄질 수 없는거고 인간 정말 영원히 죽지 않고 살길 바라는 이 심리 이용 해 그게 마치 가능한것처럼 얘기 하는게 종교 보이지 않는 신 끌어 들여서 가능한것처럼 얘기 하는거지 이 신 믿으면 만 사 형통 할것처럼 ㅎㅎ	FALSE
여호와증인 살어라 ㅡㅡ 그 들 참 종교인 줄 모르고 아는 척 허네 ㅡㅡ	FALSE
hear 여호와 증인 참 종교 너 진심 그걸 믿고있는거야 ㅎㅎ 성경 제대로 잘 읽어 보고 여호와의증인 교리 좀 깊게 정확하게 잘 살펴봐 그게 진리 너 여호와 증인 주장 신세계 아마겟돈 진짜 온다고 믿냐 에 정말 예수 하늘 왕국 왕 즉위 했다고 믿느냐 그리고 적은 무리 정말 죽으면 죽는 즉시 영 하늘 올라가 의 일부 예수 함께 하늘 공 동 통치 있다고 믿느냐 그리고 성 경 자체 하느님 영감 받은 책 믿느냐 성경 깊게 읽으면 읽을수록	FALSE
앞뒤 안 맞는 말 많다는건 모르냐 성경 예수 하느님 영 의해 정말 마리 의 태 탄생 했다고 믿는거냐 그리고 다시 죽었다가 부활 되어 영 승천 한 걸 믿는거냐 그래서 에 하늘 재림 하여 지금 왕국 왕 통치 있다는걸 정말 믿는거냐 니 눈 그거 확인 했어 예수 하늘 어디 재림 하여 지금 통치 있는데 엉 그거 증명 할 수 있어 그거 말 같지도 않는 소리 하지도 아직도 그런 허황 된 스토리 진짜 줄 빠져 사는 사람 들 있나 보네 ㅠ	FALSE
뭐 신천지 대 깨 문교 오십 보 백 보지	FALSE
헌금 목사 들 배 불리는 구조 같네	FALSE
와웅 미쳤넹 김남희 소송 지니까 별 별 뇌 있는 말 아무 이야기 다 하는구나 ㅋㅋㅋㅋㅋ	FALSE
거의 대 깨문 수준 ㅉㅉㅉ 구제 불능 ㅎ	FALSE
사이비 교주 가족 들 전부 감옥 넣어라	FALSE
신천지 구원파 문빠	FALSE
천주교 바티칸 교황청 돈 제일 많은 곳 신자 들 피 ㆍ 고름 ㆍ 땀 ㆍ 고혈 짜내서 만든 돈 가지 서 계 적 정치 하는것 상징 로고 부엉이 차라리 박쥐 하면 더 유명 할텐데	FALSE
사이비 사기꾼 그런데 거기 속 는 사람 들 더 이해 안 가는건 나 그런 건가	FALSE
나도 그래 민주당 빼고 국민 들 다 그래	FALSE
답답하다 아무리 종교 자유 해도 참 믿을걸 믿어라	FALSE
늘 얘기 하지만 조선 땅 개독교 섹스 그저 불륜 찔의 온상 바로 교회 모두 잡아다 총 쏴 죽여야 한다	FALSE
세기 과학 시대 합리 적 사고 없이 아직도 유일신 맹신 하는데서 모든 비극 시작 된다 중세 기독교 이슬람 전쟁 근세 기독교 신교 구교 싸움 현대 이슬람 서구 대한 테러리즘 유발 도전 등 똑같은 개념 신인데도 자신 옳다고 맹목 적 주장 하는 데 모든 비극 출발 한다	FALSE
신천지 신도 들 이만 희사 기군 지옥 가라 해봐 그럼 너 죄 사 해줄거고 천국 보내줄게 엉 기회 다시 안	FALSE
이 여자 지금껏 같이 살다가 무슨 뜨 금 없는 말 하는지 이해 안된다 남편 아이 둘 있는 여자 웃 낀다	FALSE
어차피 빠져있는 사람 모른다 백 날 천 날 말 해봐야	FALSE
아무리 종교 자유 게 있다지만은 이건 아닙니다 신천지 교주 이만 희 구속 시켜야 됩니다	FALSE
성경 양 탈 쓴 이리 구절 있습니다 신천지 종교 탈 쓴 사 기단 입니다 종교 자유 교묘히 이용 합니다 이참 국가 강제 수사 하 피해자 들을 구해 합니다	FALSE
신 늙겠냐 ㅋㅋ ㅋ 곧 뒤지게 생겻는데 어리석은 것 들	FALSE
이 여자도 웃 낀다 남편 아이 둘 있는데 하늘 맺어 준 베 필이다고 결혼 이 여자도 속셈 있어서 같이 살아왔다는 생각 든다	FALSE
신천지교 전부 집단 수용 후 정신 감정 해야 할것	FALSE
저기 빠진 사람 들 더 이해 안감 이 희 배 불리 하는 정신차리세요	FALSE
신천지 사회 적 문제 심각합니다 종교 왜곡 하여 순수한 사람 들 이용 해서 사기치는데 어떻게 인간 하나님 되겠 읍 빨리 정신차리고 제자리 가셨으면 하네요	FALSE
야 지금 실검 이만 희 윈데 싹 내리는거 보소 이만 희 하나 치면 신천지 무너지는거 다 들 모르는 사람 없지	FALSE
신천지 제주 엄청 많음 ㅎㄷㄷ 제주시 인제 있는 탐나 마트 건물 신천지 성전 있음 층 기억 함 간판 없어서 주변 보면 모름 제주 시청 인제 설문지 돌리는 사람 거의 신천지 임 조심하세요	FALSE
신천지 인이시군요	TRUE
저런 사이비 신천지 다니는 사람 이해 못 한다	FALSE
자랑 ㅋㅋㅋ	TRUE
신천지 니 들 중국 교 세 확장 중 대구 신천지 사이비 교도 코로나 걸렷어 니 들 중국 바이러스 가져오고 니 들 사이비 안 코로나바이러스 퍼지고 그게 일반인 도 퍼지고 있는거 아니냐	FALSE
혀 경 영교 교주 허경영 이 국회 대선 나온다네 전 국민 들 매달 씩 공짜 준다고 하니 관심 가진 국민 들 늘어 간다 참 재미있는 세상 그래도 이만 희는 대선 출마 안 하더만	FALSE
공짜 주는 게 아니라 당신 뺏긴 돈 되찾아 당신 되돌려 준다는 것 모르면 알아야지 가르쳐줘도 모르면 알때 기다려야지 방법 있겠나 그 교주도 아니고 동방 등불 당신 결국 나중 그 따르게 된다 이는 필연 이 므	FALSE
제발 빠져나와라 본인 삶 살아가 사이비 발 묶여서 암 껏 못 하지말고 신천지 가서 가족 들 위 하여 기도 할 시간 가족 들 함께 시간 보내라 종교 잘 못 된 의지 하지 책 읽고 스스로 깨우쳐 바로 서는 사람 되라	FALSE
신천지 이만 희 좀 없애자 이딴 것 들 자유 이름 설치는 꼴 그만 보고 싶다 제발 좀	FALSE
너 같이 놀았잖아 그게 니 말 사실 이면 너 또한 화 녀 ㄴ 이지 너 사기 겁나 쳤 다드 ㅋ	FALSE
저런 치부 보고 포교 활동 하 신천지 젋 이 들 어턴 뇌 갖고있을까	FALSE
사 초동 좌파 걑 것 들 무엇 정답 것 모르고 조국 문 재앙 정경 심 외처 봤자 교도소 제 의 고향 짐작 못 하는것 들 머리 비었고 ㅡ 주둥이 남아있는 좀비 귀신 들	FALSE
이만 ㅎ 사기꾼 가라지	FALSE
이만 희는 희 대의 종교 사기꾼 김남희 증거 있다 멀쩡한 사람 들 친절 위장 신천지 너무 많이 포섭 되어 있다는게 문제 하루빨리 이탈 탈출 하길 말씀 그렇게 강 조항 션 왜 진짜 성 경 말씀 분별 못 하는가 신천지 이제 무너질 것 김남희 인간 적 욕심 부귀 권세 누릴 위치 양심 일 깨우니 폭로 하는거 아니겠나 제발 신천지 신자 들 탈출 하길	FALSE
왠 일로 댓글 뷰 대가 조용하네	FALSE
두 년놈 들 똑같은 고도 사기꾼	FALSE
신천지 빠진 분들 정신차리세요	FALSE
니 바보 나쁜 것 남편 자식 고통 안중 없이 육적 부인 돼서 부귀 영화 누리려고 하다 뭐 꼬인게 있으니 정의 사도 인양	FALSE
이만 희를 따르는 무리 들 새 머리 수준 아닐까	FALSE
종교 빠지면 저렇게 되는거 다 알면서도 빠진 사람 모름	FALSE
이런거 믿는 돌 i 도 찐 짜있냐 그냥 ㄷㅈ	FALSE
하느늠 부처님 마리아 등등 절대로 신 될수 없다 자신 신 노력 해서 살아라 남 것 튿어먹 사는자는 벌 받는다 에이 구 믿는자 들이 문제 나 자신 믿고 따르면 구원 온다 종교 나자 신교	FALSE
뻔한이단 속임수 내용 신천지 개천 지라고하지	FALSE
길거리 지하철역 안 무슨 설문조사 한다면서 이런저런 핑계 접근 하는 대 청년 들 그런 식 이용 하는 이만 희도 그렇고 그렇게 하는 너희 들 정신차려라	FALSE
교회 발 들여놓는 순간 못 빠져나오지 아예 멀리 하 셈	FALSE
만 희도 남 희도 꼴깝 떨지 사이비 종교 빠진 사람 들 다 집 돌아가세요 사회 악	FALSE
결국 다 죽고 헛 된것 들은데 그렇게 어리석냐 이 기사 보는 모든 신천지 인간 들 정신차려라 결국 너희 들 갈 곳 한 곳	FALSE
ㅡㅡㅡㅡㅡ 쓰레기 집단	FALSE
에혀 아직도 정신 못 차리는 사람 들 많은디 이런 기사 낸다고 정신차릴까 세뇌 얼마나 시켰는디 ㅡㅡ	FALSE
예수 “ 인자 올 때 세상 믿음 보겠느냐 ” 눅 는 의미 심장 질문 하셨다 우리 본 바 같이 그 분 세상 상태 노아 때 같을 것 선언 하신다 바울 끝날이 가까워 올 수록 악 증가 되는 것 보리 우리 경고 다 “ 성령 밝히 말씀 하시 기를 후일 어떤 사람 들 믿음 미혹 케 하는 영 귀신 가르침 좇으리 ” 딤전 그 사도 “ 말세 고통 하는 때 이르리 ” 딤후 말 한다 그 경건 모양 가진 자 들 가운데 발견 될 놀라운 죄 일람표 제 시한 다	TRUE
사이비 이단 빠지는건 마치 보이스피싱 사기 당하는거랑 비슷한듯 본인 빠지면서 빠지는줄도 모르다가 이미 때늦은 후회	FALSE
이딴 말 않 되는것을 믿고 다니는 요 상한 사람 들 참으로 한심할 뿐	FALSE
그냥 종교 맹신 하는 사람 들 중 정상인 못 봄 ㅅㄱ 정상 보여도 이미 세뇌 된 정상 임 다른 부분 정상 적 판단 하는데 종교 부분 비정상 적 논리 접근 함 그만큼 그 부분 정신 적 결함 있다는 뜻 종교 것 신앙 부분 초점 맞추고 자기 위로 맞춰 숭배 해야하는데 있지도 않은 신 같은거 만들어가지고 그걸 쳐 믿음 애초 없는걸 믿는데에서부터 근본 적 오류 발생 했음에도 판단 자체 못 함 신 네 죽어야 세상 도움 된다고 계시 했으면 죽 신도 들 몇 될건데 ㅋ 그냥 정신병 걸린 집단 임	FALSE
이단 특징 자신 예수 그리스도 자신 믿으면 구원 받는다고 뺑 다닌다 근데 믿는 사람 들 문제 어떻게 인간 신 될수가 있지	FALSE
단물 잘 빨다가 이제 와서 무슨 똑같은 것 들	FALSE
어차피 똑같은 개독 들 ㅉㅉ	FALSE
종교 자유 인정 하 데 제발 저 넘의 사이비종교 들 다 쓸어 버리자 교주 이하 사이비 사기꾼 들 모두 사형 혹은 무기 다스리고 교단 전 재산 국고 몰수 이런 법좀 만들어라 이 국 개 의원 들	FALSE
오늘 신 천 지애 들 전단지 돌리고 이 추운 날씨 떨고 있냐 그만해라 이만 희가 너희 들 영혼 가지 장난 치 뒤졌잖아 인간 죽으면 본인 한 짓 저 세상 가져가지	FALSE
이런 거 빠지는 인간 들 있다는게 놀라 움 돈 상납 강요 하는 집단 사기꾼 끝	FALSE
신천지 아웃 ㅡ 이만 희 지옥	FALSE
누가 봐도 딱 사기 ㅂㅅ 같은 곳 인대 왜 믿는거지 답답하다	FALSE
어차피 종교 사업 아니였던가 대형 교회 들 보라 빨갱이 외치 며 들은 대놓고 세습 우상화 열 올린다 빤스목사 보라 목적 돈 다 따르는 무지한자 들 얻는게 없다 자업자득 부모님 잘 들 챙겨라 날 추운데 그런데 따라가서 고생 시키지	FALSE
응 정상인 눈 괴독 신천지 둘다 우리 사회 설사 똥 ㅇㅇ	FALSE
저 사기꾼 들 마약 반응 검사 하면 반드시 양성 나올거다 무식한 정신 병자 들	FALSE
종교 이제 매 맞을 때 되었다 자유 주어 관리 안되고 선 넘으면 매 맞아야 한다	FALSE
사회 암 적 사이비 누가 좀 쓸어 버렸음 좋겠다	FALSE
돈 있는 곳 마귀 꼬인다 음 리	FALSE
테 양계 밖 지나는 보이저 웃겠다 테끌 못 지 구안 불사신 뭐 하며 바글 거리 모습 얼마나 덧 없고 허무한 짓 걸	FALSE
지저분한 김남희 이만 희 신도 들 돈 갔다 받치니까 할 짓 없어 🐕🐕 지랄	FALSE
이 우리나라 법 종교 자유도 있기 때문 건드리 기 힘듬 도 닦는 애 들 때문 경찰 여러 번 신고 했는데 저 법적 제재 할 것 없고 종교 자유 때문 뭘 못 한다고 했음 기껏 해봤자 과도 포교 활동 벌금 물리는게 전 부임 법 딱 정 하지 않는 이상 여기저기 사이비 활동 많이 할 듯	FALSE
이 여자 무슨 평화 회장 이런 거 누가 시켜 줍니까 세상 왜 이럴까 요	FALSE
방면 끼리 갈아 서고 교주 죽엇다 고 바로 통장 들 튀던 넘 들 대 숭 진리 별반 다를게 없지 제발 정신차려라 복지국가 빨리 실현 되야 ㅜ 이런 사이비 들이 못 설치지	FALSE
종교 자유도 좋지만 누가 봐도 사이비종교 제발 싸 그리 잡아가 두자	FALSE
신천지 이단 이 것 들 맨날 교회 안 가면 지옥 간다 이단 아니라고 주변 씨부리고 다니더라 아무리 종교 자유 있다지만 한 인간 신격화 그걸 믿는 어리석은 자 들 넘친다는게 이해 안감 그리고 제발 종합 운동장 모임 좀 갖지말아라 관광버스 땜 짜증난다	FALSE
이미 이나라 종교 타락한지오 래야 그러니까 저런 사이비종교 이 활개 다니지	FALSE
모두 유권자 되어서는 안된다는 문제 잘 보여주는 사례 생각 되네요 저런 상황 그 많은 신도 들 무조건 따르고 믿는 상태 그런 상태 투표 하는 거니	FALSE
악 축 온갖 짓은다하고 돈 도벌 참 좋은 세상	FALSE
어쩌면 일부다처 이슬람교 나을지도	FALSE
귀 신천지 마니교 위증 막장 복 마전 SCJ 는 종교 집단 아닙니다 뭔가 오해 들 하시는데 원래 기독교 계 나온 곳 아닙니다 그냥 사이비 집단 들 틈 바구니 나온 유사종교 사기 집단 종교 빙자 사교 집단 CULT 불과합니다 정확히 들 아셔야 됩니다 물론 인터뷰 나온 김 원장 멀리 하는게 낫	FALSE
대한민국 교회 그 밖 믿음 비지니스 목적 돈 신 정답 이 다난 돈 믿지 신은 안 믿는다	FALSE
궁금한게 어린 대학생 들 왜 가는거 임 소문 등록 비 조금 준다던데 맞는 건가	FALSE
당연히 저 두 알 나중 사회인 되면 배 먹을거란 걸 그런데 얼마 주는지가 관건	FALSE
귀신 그렇고 신앙 그렇고 영적 약해질 때 훅 하고 내 자리 들어와 현혹 시키고 사람 본성 바꿔 놓는거 같음 본인 본인 선한 마음 본인 주관 살아가는 분 들 그런 거 잘 현혹 되지 않고 무교인 분들 많음	FALSE
너 똑같지	TRUE
이런 사이비 빠지는 사람 들 뭐	FALSE
참 이 것 도기 사거리 욕 나온다	FALSE
믿을게 없어서 사이비종교 빠지는 멍청이 들 한두 명 아니구나 ㅡ 그 냉 싹 다 약 먹고 가시 지그	FALSE
속 는 년놈 들 사람 일까	FALSE
신천지 이만 희 조사해 박 그네 가장 억울할 거 반드시 응징 해야	FALSE
사이비 믿는 머 저리 들 도대체 어떤 인간 들 금은 보화 들고 뭘 전 세계 싸 들고 오고 법적 결혼 사람 육체 적 성노예 시키고 돈 삥 뜯기 위해 온갖 거짓말 일삼 는 사기꾼 도대체 뭘 믿고 가는지 얼마나 미련 현 실감 떨어지면	FALSE
사이코 사이비종교 집단	FALSE
사이비 믿는 애 들 참 ㄹㅇㅋㅋ 머리 뜯어서 들여다보고싶음 얼마나 멍청하면 속 ㅋㅋ	FALSE
기자 천주교 기독교 요셉 이 이름 종교 스 멜이 강하게 온다	FALSE
진짜 어떤 사람 이길래 저런 교리 신 적 믿고 따르는지 넘 안타깝네요	FALSE
신 어디 있어 널 만들어 주신 건 너희 부모님 바보 들 여기 쫓아 다닐 시간 부모님 효도 해라	FALSE
신 천 지애 들 구원 은행 정 하는 이유 모름 ㅋㅋ 저기 신용 불량 자 없음 ㅋㅋㅋㅋㅋㅋ 무신론자 사기꾼 들인건데 그걸 모르네 ㅋㅋ	FALSE
사이비종교 믿는 년놈 들 예수 예수 하는 세상 한심한 것 들	FALSE
저런 말 안되는걸 믿는 모자란 사람 들 진짜 있는건 가요	FALSE
저늠 저늠 ㅡ 가장 어리석은 것 들 교주 신인 줄 착각 자 뻑 들 허 능 신도 것 들 ㅡㅡㅡ 지 들이 무슨 짓 하는지도 모르 능 우매 거이 들 😡😡😡😡	FALSE
동방 신교 ㅠ 전능하신 하나님 교회 심지어 중국 사이비	FALSE
믿고 안 믿고를 떠나서 저런 허 접 교리 속 넘어가는거 자체 우습다 남편 두 아이 버리고 저런 사기꾼 물 빨 십 수년 했단 거 어휴 드럽다	FALSE
이만 희 사기꾼 개 xx 끼 번 외치 천국 갈수 있다 이건 진리	FALSE
이 ㅇ 희가 여보 부르며 잘 못 했다 비는 전화 목소리 조작 할수가 없죠 확실한 ㅇㅁㅎ 음성 맞넹 ᆢ	FALSE
보내 드릴 까요 ㅅㅊㅈ 바로 내렸고 푸른 하늘 투 님 유튜브 보시 거기 댓 링크 되어있어요	FALSE
돈 보고 간거 아니냐 이만 희가 돈 뺏을려니 이 제사 폭로 하는 거고 돈 바치 몸 바치던 신도 들 생각 안나 지 생각 나젴	FALSE
신천지 교도 들 이 사실 모르는건 가요 이 걸 알고도 신천지 믿는 건지 이해 안가네요	FALSE
신천지 신도 문 재앙 교 신도 대가리 깨져 봐야지	FALSE
박 그네 대통령 엇으 지금 쯤 코로나 전국 퍼졌을걸	FALSE
박근혜 추종자 들 태극기 부대 비슷하네	FALSE
술 많이 하셨네 주무셔요	FALSE
최고 댓글 선정 퍼 알립니다 인정	TRUE
신천지 버금 가는 넘 여기 있네 햐	FALSE
그것 사람 나름 지기 친구 들 열심히 믿지만 한번 교회 자는 얘기 안함 무조건 욕 하는건 나쁜 걸 넘어서서 마음 아프게 한다	FALSE
문제 있어서 쫓겨나 갔 겄 꿀 다 빼먹고 이제 먹을거 없으니 문제 있는것처럼 덮어 씌 어 쫓아냈 겄 더럽고 사악한것 들	FALSE
법원 김남희 한 짓 모두 유죄 판결 났어 그럼 법원 욕 해야지 왜 그런 판결 했냐고	FALSE
사이비종교 한번 빠지면 못 빠져나오고 이성 미비 되어 무조건 사이비 교주 맹신 하지요 그리고 우리나라 정치 한번 문빠 빠지면 이성 잃어서 합리 적 판단 못 문재인 정권 잘 하든 못 하든 무조건 문재인 맹종 하지요 조국 대한민국 평등 공정 그리고 정의 기준 완전히 파괴 했는데도 사이비 교주 미쳐 복종 하 듯이 조국 수호 외치지요 조국 백서 쓰는 정신 나간 인간 들 있구요 그리고 추미애 같이 온갖 술수 반칙 국정 농단 하면서 부정선거 문 빠 들 불법행위 파헤치지 못 하게 방해 하구요	FALSE
이단 사이비 차이 이단 예수 부활 삼위일체 부정 성경 적 해석 오류 사이비 교주 자신 하나님 예수 천사 대언 자 제사장 기타 신격화 하는 집단 사이비	FALSE
S 나라 곧 신천지 나라 제사 장이 되어 영 육 합 일체 곧 육체 죽지 않고 영생 한다는 허무맹랑 교리 세뇌 되고 중독 되어 정신 창란증 앓고있는 맹 들일 뿐 지금 대 깨 문과 내 조국 하며 국민 상대로 말장난 사기 우롱 하는 자를 비호 옹호 하는 일부 정신 간자 들 같은 부류 본다	FALSE
저리 폭로 하면 머 하냐 쟤 가하는말은 거짓말 이러면 끝일 걸 신천지 다단계 세뇌 당 한 애 들 못 나와 ㅋㅋ	FALSE
사기꾼 실체 만천하 드러나 단죄 받아 사라지길	FALSE
걍 울 나라 기독교 없애라 그게 답 일듯	FALSE
일반 기독교 뭔 차이 예수 이만 희든 둘다 신은 아니 자 예수 사람 들 만들어 놓은 허상 물론 부처 그렇고	FALSE
들다 음부 가겠는데	FALSE
이만 희도 문제 김남희 깨끗해 보이진 않네	FALSE
이런 기사 십알단 들 뭐라고 댓글 쓸 라나 지 들 홍보 기사 어머나 이런 멋진 일이 있나요 선 한일 많이 하는군요 개떼 몰려와서 이딴 식 댓글 도배 들하던데	FALSE
이 걸 믿는 사람 들 정상인 할 수 있을 가	FALSE
근거 없는 개 소리 하 마라 감히 천 목사 님 어디 빗대냐 당신 천벌 받는다	FALSE
이유 없이 모임 들어서 애 엄마 들 아이 들 대학생 들 무료 공부 이런 거 조심합시다	FALSE
대 깨문 들이 더 문제	FALSE
신천지 신도 들 진지하게 이만 희가 영생 불사 한다고 믿나요 진짜 궁금함	TRUE
교주 내 연 녀 ㅋㅋㅋㅋ	FALSE
것 살 상 할아버지 ㅋ	TRUE
사기꾼 달라붙은 기생충 그걸 믿는 등 h ㅣ 머 저리 호구 들	FALSE
종교 중 사이비 따로 있나 다 똑같은 것 들 정치 마찬가지 빨갱이 종교 헤어 나오질 못 하는 것 들 많아	FALSE
어이 읎 ㅋㅋ	FALSE
교조 해당 교 창립 한자 교조 자체 그러시다면 ㅋㅋ 혹시 그 오랜 세월 지냈음에도 달리 나온건 서로 그동안 필요 의해 관계 유지 하 다가 서로 이익 면 맞아 떨어지지 않자 그간 알 있던걸 ㅋㅋ 폭로 하며 종 치듯 알리시는건 아닌지 강한 의 구심 드네 ㅎㅎ	FALSE
임 보혁 기자 부끄럽지 않게 중립 적 기사 좀 부탁드립니다 양쪽 말 다 들어 보셔 야하는거 아닌가요 자기 주머니 돈 챙기려다 쫓겨 나선 이 젠 본인 내 연 녀 주 장하나 보네요 어이 없어서 ㅎㅎ 하 말 같지도 않은 거짓말 써나서 이 걸 믿는 바보 들 또 있을까 싶네요	FALSE
이 왜 말 같지 않은 거짓말 임 엉덩이 만지는 모습 카메라 잡히고 동네 사람 들 부브인줄 아는데 ㅋㅋㅋ	FALSE
ㄴ 부축 하다가 그런 걸 사진 찍고 인신공격 참 할 일 없으신 가봅니다 남 헐뜯을 시간 기도 한번 하세요 있지도 않은 사실 얘기 다니는거야말로 범법 행위 명예훼손 입니다	FALSE
재밌닼 ㅋㅋㅋㅋㅋㅋㅋㅋㅋㅋ 신천지 개 웃기구만	TRUE
Hoooo 있지도 않은 사실 아니구요 동영상 다시 자세히 보시 부축 따위 없었습니다 정신 좀 차리세요 신천지 거짓말 모략 교리 포함 시킨 이미 사회 각 분야 사이비 종교 인정 된 쓰레기 종교 입니다 이만 희는 사기꾼 입니다 ㅎㅎㅎㅎㅎ	FALSE
이만 희는 성 불구자 입니다 근데 내 연 녀 신천지 안 좋아하지만 이건 쫌 구라 같네요	FALSE
여기 신천지 사이비 신도 들 대량 납시었네 ㅉㅉㅉ	FALSE
광신도 들 교주 직접 자기 사기꾼 양심선언 해도 교주 목 따고 신앙 지킬 놈 들	FALSE
ㅇㅇ 지금 자기 인생 무의미했다는것을 인정 하기 싫거든	FALSE
제 친구 그래요 홍준표 하는 사람 친구 돼지 발정 제 말 나왔을 때 나쁜 놈 거품 물더니 안희정 때 남자 그럴수있지라고 하고 조국 사건 자식 가진 부모 다 그런데 조국 불쌍하게 왜 그래하는 거 죽어도 하나님의교회 안상홍 진리 하는거 렁 같은 사이비 종교 같네요	FALSE
ㅋㅋㅋㅋㅋ 바로 위 댓글 쓴 정치 병자 마찬가지 광신도 정치 병자 답 없기는 마찬가지	FALSE
홍준표 안희정 조국 관련 다 사실 그걸 정치 병자 몰아가네 ㅋㅋ 누가 정치 병자	FALSE
인지부조화	FALSE
너희 모든 이스라엘 백성 들 알라 너희 십자가 못 박고 하나님 죽은 자 가운데 살리신 나사렛 예수 그리스도 이름 이 사람 건강하게 되어 너희 앞 섰느니라 이 예수 너희 건축 자 들 버린 돌 로서 집 모퉁이 머릿돌 되었느니라 다른 이 로써 구원 받을 수 없나니 천하 사람 중 구원 받을 만 다른 이름 우리 주신 일이 없 음 하였더라 행	FALSE
김남희 씨 거듭 났다니 다행 요 신변 보호 필요한건 아닌지	FALSE
신천지 대해 크게 오해 하시네요 성경 통해 하나님 선민 무엇 약속 이루어 나가시는지 하나님 살아서 역사 하 심 깨우쳐주는 곳 신천지 입니다 양 들 꼴은주지 않고 이단 프레임 신천지 철저하게 견제 하려는 말씀 없는 목사 님 들의 거짓말 속지 마세요 실제 보시 말씀 공부 합니다 말씀 이 하나님 이 신 데 하나님 두려워서 나쁜 짓 못 해요 공중파 지상파 신천지 불미 일로 뉴스 온 즉 있나요 신천지 이단 몰아 세우는 기독교 방송 별 내용 없 이비 방만하잖아요 값 없이주라는 말씀 없고 말씀 나오는 곳 못 가게 막고 성도 들 돈 호의호식 하는 목 들을 의심 없이	FALSE
믿고 따르는 성도 들 안타깝네요 말씀 없고 연일 터져 나오는 뉴스 목사 님 들 세습 횡령 성범죄 전 굉훈 목사 님 하나님 까불면 나 죽어 이런 발언 들 보면서 사단 짓 생각 안 드시나요 하나님 함께 하신다고 믿나요 안타깝습니다	FALSE
이단 프레임 아니라 이단 잖아요 ㅎㅎ 말씀 공부 많이 하시면 알겠네 이만 희는 그냥 곧 죽 늙은 할아버지 거 기독교 깨끗하다는 이야기 아니고 이단 이단 이유 비슷해 보이 다른 걸 믿어 서죠 본인 구원 자고 영원히 산다 목사 님 없잖아요 나이 먹고 쓸데없는 욕심 부리는 목사 들 있다는건 인정	FALSE
그 위 당신 들이 믿는 신천지 이만 희를 구원 자 믿는지 대답 해 주세요	FALSE
위엣 사람 무슨 개 소리 니넨 이단 뿐 아니라 사회 악 중 악 그냥 꺼져	FALSE
예수님 그 시 대의 선민 들 이 최고 이단 욕 하면서 죽였지요 이단 하나님 아십니다 말씀 있는 곳 핍박 있다고 성경 기록 있습니다 신천지 핍박 받는건 성경 이 네 요 계시록 지금 볼수 없었던 사망 이끌던 귀 신의 나라 사라지고 고통 아픔 없는 하나님 나라 천국 신천지 새로운세 상이 이 이 땅 이루어짐을 예언 있습니다 구약 보면 예언 하시고 이루신 걸 세세하게 기록 있지요 맏 안 믿고는 본인 선택	FALSE
ㅋㅋㅋㅋㅋㅋㅋㅋㅋㅋㅋㅋㅋㅋㅋㅋㅋㅋㅋㅋㅋㅋㅋㅋㅋㅋㅋㅋㅋㅋ z	TRUE
유태인 최고 발명품 성경 예수	TRUE
세뇌 당 호구 들 영혼 불쌍	FALSE
정말 진절머리 나 고집불통 노답 집단 신 천 지 귀 틀어막고 무조건 합리화 맹신 하는 전체주의 자 들 같은 본인 들 성경 통달 했다 말씀 하나님 시 하지만 실상 성경 천하 육신 입 인간 중 구원 줄 이름 없다고 분명히 적시 되어있는데도 예수 영 이만 희에게 들어가서 이만 희 예수 하는 이단 중 이단 끝판 왕 히브리서 사람 한번 죽는것은 하나님 정 하신것이요 그 후 심판 있다 했는데 이만 희는 예수 영 들어가있기에 안 죽는다 육체 불사 하 어딘 대 어르신 안 죽는지 한번 봅시다 ㅎㅎ	FALSE
신천지 대한민국 암 덩어리 얘 너 네 땜 온 국민 불안 떨고 먹고살 길이 막막해졌는데 주둥이 말 나오세요 물어보고싶네요 사람 이면	FALSE
미인 데 이만 희에게 넘어가셨나요 신천지 악의축 입니다	FALSE
이만 희가 이 여자 넘어간거야 ㅎㅎ	FALSE
신천지 확 그냥	FALSE
악의 축 얼마나 많은 사람 들 고 통속 쳐 넣고 부를 이루었는데 희 대의 악마 악녀 들 집합 체 저런건 쳐 맞아 죽어 야할텐데 말년 제발 기도 한다 이런 것 들 곱 죽지말라고	FALSE
사이비 실체 하나 씩 하나 씩 들어나는구나 그러나 그 피해 엄청났을텐데 희생 자 들 이런 잡 ㄴ 당 한 걸 생각 하 기 찰 노릇 바보 사기꾼 당하고 미개한 중생	FALSE
미인 ㅎㅎ	TRUE
신천지 이단 입니다 어서 빠져나오세요	FALSE
신천지 빠져 나온 많은 사람 들 신천지 대표 적 종교 사이비 사 기 집단 합니다 무섭네요	FALSE
김남희 씨 화이팅 늦었지만 이제 정신차려 솔직하게 양심선언 해주니 다행 고맙네 꼭 이렇게 실체 드러나야 깨닫는가 불쌍하고 가 여운 신천지 신도 들 제발 눈 뜨고 영혼 흔들어 발 딛고 서있는 지금 현실 보아 사람 보고 어찌 신 여겼 단말 ㅠㅠ	TRUE
신천지 통일교 구원파 다 들 이단 삼단 이 더 구만	FALSE
플러스 은혜 진리 교회 목사 태극기 집회 데려감 ㅋㅋㅋㅋㅋㅋㅋ	FALSE
하나 씩 하나 씩 보내는구나 사이비 들 이제 서 그 많은 사람 들 희생 당하고나서	FALSE
신천지 OUT	FALSE
이제 신천지 폭로 하신 것 감사하네요 그 동안 삶 회개 천국 가시길 바랄게요	FALSE
신천지 친구 들 너희 스마트폰 있을테니 진짜 궁굼해 그런데 이만 희 씨 죽으면 너희 어떻게 되냐 너희 들 교주도 죽고 세습 하려는 여자애 등 돌리고 폭로 하는데 너희 인생 어떻게 되냐 ㅋㅋㅋㅋ 낙동강 오 리알 못 처지 되는거냐 아니면 이만 희가 재림 할거라고 믿고 서울역 노숙 있을꺼냐	FALSE
조용기 문선명 이재록 정명석 유병언 이만 희	FALSE
이재록 정명석 누구 나머진 다 사기꾼	FALSE
종교 믿어도 왜 이런 걸 믿을까 한 사람 영원히 죽지 않는다고 믿는 사람 들 그렇게 많다는 게 놀랍다	FALSE
그 부활 했다는 예수 어디 있나요 부활 했으면 지금 죽지 않고 살아서 활동 있어야 하지 책 써있다고 그걸 다 믿나요 그냥 그 시절 예수 사람 아주 선한 행동 들 하다가 죽었고 사람 들 그 정신 따라서 살아왔다 고 생각 하면 되는것이지 그걸 종교 프레임 가둬서 경제 적 이용 해 먹는 사람 들 돈 갖다 줘 시간 갖다 줘 ㅋㅋㅋ 죽음 뒤 일 걱정 하느라 살 있는 동안 시간 낭비하고 사는 불쌍한 존재 들 ㅋㅋㅋ	FALSE
진짜 저 사람 들 이만 희 저 노인 네 죽지 않는다고 믿는거야 미쳤나 봐	FALSE
신천지 빠져 나온 사람 들 유투브 증언 의하면 신천지 무서운 종교사 기 집단 합니다 보이스피싱 다단계 울 갈 만큼 조직 적 포섭 훈련 시켜 전도 대원 들 세운다고 합니다 잘 훈련 된 자 들 일반 교회 아파트 주민 자치 센터 운영 하는 공 방 문화센터 같은 곳 교사 선생 심어 놓고 새로 들어오는 회원 들 짜고 친 고스톱 커피 식사 장소 유인 한다고 합니다 그리고 그 중 한 사람 다가와 꿈 당신 나타났다고 하면서 미리 파악 그 사람 상황 들 맞추어 내는 것 하여 감쪽 속인다고 ㅜㅜ	FALSE
저 그렇게 당했어요 내게 귀신 어깨 있다고 자기 들 안 믿으면 빛 사라진다고 ㅋㅋ 그 당시 진짜 놀랬고 믿고 몇 달 공부 하 다가 겨우 겨우 끊 엇 그 후 도 ㅎㅎ 너무 길어서 여기	FALSE
둘다 지옥 간다 . 사기꾼 들임 어리석은 신도 들 있기에 저런 망나니 들 예수 팔 팔자 고친거다 성경책 읽어도 된다	FALSE
이만 희를 구 원자로 아는 인간 들 정신 좀 차리길 바란다 어휴 암기 잘 하면서 왜 머리 돌리지 못 할까 ㅋㅋㅋㅋ	FALSE
나무 열매 안다고 열매 봐라 보고 보지 못 들어도 깨닫지 못 하는 자 들 소경 소경 인도 하는 도 ㅋㅋㅋ	FALSE
진 찐 웃기는 사이비 집단 저런 걸 믿냐 미련 한 사람 들 예수님 의사 아가페 사랑 입니다 신천지 조건 부 사랑 아닙니다 생각 좀 해보시길	FALSE
이제 악의축 끊고 신천지 고발 하 회개 돌아오신게 너무 감사 네 신천지 물러가 야합니다	FALSE
신천지 완전 사이비 깡패 잖아 ㅎㅎㅎ 사람 붙여서 감시 다 던데 ㅎㅎㅎ	FALSE
쟤 신천지 신도 들 불러다가 결혼식 함 불륜 주제 하나님 빙의 해서 누가 누굴 구 원 한다는 건 그냥 정신병 자 집단 제 정신 이 일 년 돈 천만원 바쳐가며 딸 이 노릇 하 것	FALSE
추하다 추해 저걸 믿다니 창피한 인간 들 ㅉㅉ	FALSE
이단 들 공통 적 특징 절대로 죽지 않는다던 교주 덜컥 죽으면 그 자리 다 들 해체 해야 맞는데 다른 여성 세워서 유지 해 나간다 이런 추접 모습 자기 두 눈 뻔 히 보면서도 거기 따라가는 영혼 들 측은하다 우리 인간 사람 은 절대로 구원 자 될 수도 없고 그런 째 비 되지도 않는다는 걸 알아야 그런 데 빠지지 않는다 자기 소중한 영혼 그런 이 단 집단 맡기거나 내려놓지 말라 자기 영혼 스스로 지켜야 한다	FALSE
다른건 모르겠고 우리 회사 신천지 들 정말 악마 같다 교활하고 무례하고 욕심 많고 이기 적임 하나님 아들 들 머 어떻게 그리 사악할까	FALSE
우와 그런데 총회 보고 왜 이죠 총 회장 dvd 살 돈 계산기 사 드리는 건 어떨까 요	FALSE
아는 사람 전남 영 암 출신 신천지 쇠뇌 당해서 나 교회 자고 권유 그토록 좋으면 너희 부모 형 누나 권유 해라 그 이후 전화 찬단 그 인간 세 고시원 살고있다 미쳐도 적당히 미쳐야지 곱 미쳐야지	FALSE
요즘 신성한 종교 어디 있나 돈벌레 들	FALSE
한국 기독교 총 연합 회 교단 교회 들 일 제때 일본 천왕 참배 절하 군수 물자 바치 청년 들 전쟁 터 보내고 교회 종 바치 게 종교 한국 기독교 총 연합 회 대표 하나님 까불면 나 죽어라고 하는 것 게독교 사이비 이단 입니다 말 한 거 교 모르나 불쌍한 교 성 경안 들어와 신앙 하세요 목사 말 믿지말고요 참 하나님 말씀 안 성 경 말씀 봐라 이사야 장	FALSE
힘내세요 그런 목사 밑 계셨나 본데다 그런 것 성급한 일반 화 오류 빠지지 마세요 과오 있는것도 맞고 교회 죄인 들 오는 곳 이기 그러합니다 하지만 회개 돌이킨다면요 그래도 개독 욕 하시겠습니까	FALSE
댓글 모음 봐라 신천지	FALSE
응 이만 희도 곧 통일교 문선명 처럼 곧 죽어 북한 신 김일성 김정일 죽었어	FALSE
거짓 미혹 하는 사이비 집단 청소년 들 끌 들여서 인생 망치 하고 가정 박살 낸다	FALSE
하 또 이상한 종교 만들고 선봉 자 김씨 해서 나오겠구만	FALSE
사람 한번 태어나서 죽는 것 정해진 것 입니다 사도신경 죽음 후 몸 부활 영생 믿는 것 예수교 이지 왜냐하면 예수 죽어서 째 되는 날 부활 했고 이처럼 그 믿는 성도 영생 약속 하셨어요 이 가능한 것 하나님 인간 몸 입고 오신 분 예수 그리스도 이기 때문	FALSE
사후 영생 어쩌 하지말고 선하고 숭고한 삶 영위 하시길	FALSE
예수님 하늘 올 리우 심 본 그대로 다시오시리라 성 경 말씀 기억 하십시요 인간 예수님 일수 없 음 안타까운 그런 믿음 성경 예수 찾으십시요	FALSE
제발 한 발짝 떨어져서 신천지 보세요 아닙니다 ㅠ 제발 깨어계세요 우상숭배 그 속 나오세요	FALSE
저런 사 기 집단 속눔 눔들 제 정신 아니지 ㅉㅉㅉ 부모 형제 전부 외면 하 게 정상 적 종교 ㅉㅉㅉ	FALSE
인간 신 하는 종교 전부 사기	FALSE
와아 정말 뒤늦게 깨 달았네 길 바닥 사람 붙잡고 포교 활동 하지마라	FALSE
저 교육 받는 도중 나왔어요 자유 존재 하지 않습니다 전도 활동 강제 구 여자친구 빠졌다가 헤어졌어요 여자친구 못 사귀게 하고요 강제 입니다 ㅜㅜ 자존감 낮은 사람 들 모아서 세뇌 시킵니다	FALSE
ㅎㅎㅎ 신천지 신자 들 배울만큼 배우고 에지 간 하면 거의 고등교육 수준 은 될텐데 영생 불사 믿는다는게 도데 체 상식 있는 사람 들 그리고 내 연 관계 뭐람 그리 성스러워야 할 사람 성욕 하나 주체 못 해 내 연 관계 ㅎㅎㅎ 웃고 잡다	FALSE
개신교 잘 해라	FALSE
딴건 몰라도 자신 신 하고 영생 불사 외치는것 들을 왜 믿지 많이 믿고 영생 불사 해 한 천년 씩 들 사시길	FALSE
지금 한국 교회 신천지 지 들 밥그릇 쌈	FALSE
쯧쯧 머리 든게 없으 신건	FALSE
명안에 들어가야 구원 받는다고 근데 왜 전 도해 에서 밀리 어쩌 려고 그래	FALSE
제대로 알 말 사세요	FALSE
사후 세계 걱정 하지 현생 걱정 하며 열심히 살아라 죽으면 다 부질없다	FALSE
진짜 신천지 그냥 악의 소굴 악마 집단 임	FALSE
다 알면서 추종 하는거 아니야	FALSE
아 그리고 한마디 더 워낙 기독교 ㅅㅊㅈ 예방 홍보 하니 요새 주 타겟 일반인 중 고딩 대학 신입생 들 조심하시길 그냥 아무 것 잘 모르는 애 들 꼬시는데 혈안 임 ㅋㅋㅋㅋㅋㅋㅋ	FALSE
신천지 탈출 대 깨문 탈출 지능 순 임	FALSE
신천지 사람 들 정말 불쌍하다 돈 바치 몸 바치 시간 들 정성 들 솔직히 다른 어떤 종교 이단 종교 들 정말 자신 인생 거의 바칠 정도 헌신 적 이렇게 이단 명명백백하게 나타났는데도 믿고 있다니 그래도 이렇게 양심선언 해준것에 감사하다 더 이상 피해자 줄듯 하니	FALSE
일간 기사 건 모두 돈 주고 낸 광고 였습니다 성도 들 눈 가리고 ㅠ 이용 있어요 제발 그 진리 말씀 게 거짓 이기 않을까요 그럼 뭐 두렵나요 제발 한번 들어 보시 신천지 떨어져서 봐 보세요	FALSE
참 불쌍하다 이용 당하다가 버려지고	FALSE
잘 했어요 누구 이만 희 가까이 지냈을 터 신 천지인 들 저렇게 정신 좀 차려 야할텐데	FALSE
거두 절미 그걸 이제 알았다고 떠벌리는거냐 참 한심하네 한심해 ㅎㅎㅎ	FALSE
사이비 다 안다 너 그런다고 지금 정신 나간 사람 들 제 정신 되긴 힘들지	FALSE
ㅋㅋ 겨우 이만 희 따위 신 알았다면 너 가능성 없지만 그래도 참회 하고 있으니	FALSE
거짓말 아무 한 테 얘기 하지 말 부모 속 알았을 땐 아이 가출 시키는 가정 파괴 범 집단 입니다 모든 것 멈춰 버린듯 한 하루하루 울면 보내고 있습니다 ㅠ 아이 는 구원 사기 공포 조 장해서 모함 하여 영영 집 돌아갈수 없게 만드는 신천지 들 자녀 잃어버린 혹은 부모 잃어버린 슬픈 맘 안다면 속히 돌려 보내세요 더 이상 또 다른 청년 들 가정 들 찢어지는 아픔 속 살 않기를 진심 기도 바랍니다	FALSE
니 영감 사귀다가 갈라져 폭로 해도 니 죄 안 없어 진다 니 활동 신도 들 이만 희 더 굳게 믿게한 부분 있으니깐 너 이만 희나 지옥 불구덩이 땔감 감 솔직하게 말 해라 양심선언 하지말고 이해관계 틀어진 복수 보복 진실 발언	FALSE
하나님 믿는다면 골방 조용히 기도 성경 낭독 해도 된다 그 목사 들 교주 숭배 하는 것 아니라 뭐 잘 못 되어도 한참 잘 못 되었다고 생각 하지 않나	FALSE
이런 기사 왜 신천지 것 들 개떼 몰려들어서 댓 안 씀 ㅋㅋ 딴 신천지 기사 자기 들 끼리 북 장구 댓글 쓰고 난리 들 이 더 ㅋㅋ 너 네 정상 아니고 모 지리 들 이만 희 할배 놀아난 세상 제일 모자라고 악 나라 것 들	FALSE
이 단 사이비 굳이 실체 폭로 하지 않아도 당연한 것 코미디	FALSE
나이 살인 할배 한국 짊 어 갈 젊은 신도 들 많다는게 안타깝다 어리석고 딱 봐도 이단 ᆢ 빨리 빠져나오세요 젊은이 들 ᆢ	FALSE
이만 희라는 인간 똑똑한 놈 믿는 인간 들 불상 거지	FALSE
너 돈 미친 암캐 보인다	FALSE
저 여자 이만 희가 파푸아뉴기니 와서 행 숫 거짓말 들 잊지 않고 있습니다	FALSE
이만 희가 돈 안 줬구만	FALSE
신천지 과거 박근혜 선거 적극 지지 했지 지금 누구 종교 과세 해야 한다 자 한당 반대 했지	FALSE
종교 자유 보장 되어야 하지만 이 것 들 거의 셋업 범죄 조직 벗어날 수 없는 구조 만들잖아	FALSE
이런거 믿는 사람 들 더 신기하던데	FALSE
헌금 걷는 종교 죄다 사이비 뭐 예 수도 헌금 바구니 돌리고 atm 헌금 받았는지 의문	FALSE
불신 자 넘 들은 왜케 멍청한지 얄마 진리 알아보려고 한적 있냐 개멍 청	FALSE
nap 그 진리 헌금 라면 너 무지함에 찬사 보낸다 하나 작자 예수 돈 벌어 오라 인류 창조 헌금 수급 자 예 수 보냇 ㅋㅋㅋㅋㅋ	FALSE
sumi 하나 돈 벌려고 인류 창조 했다는거야 니 들 논리 공룡 원시인 조차 없어야 되는데	FALSE
왜 국민일보 ㆍ CBS 만 보도 하지 다른 방송사 보도안하네 진실 이면 대박 사건 이상하네 게독교 신문 그 런가 알아보니 김남희 교 돈 빌리고 안 갚아 쫏겨났다 교인 들 사기 쳤다며 그리고 저 사진 다공 개 해봐라 짜집기 하지말고 제발 정신차려라 게 독신 문 방송사	FALSE
김남희 신천지 활동 하다가 돈떼 먹고 법적 지니 인심 공격 하 자를 뭘 믿고 신천지 나쁘게 하여 공격 할 자를 찾으시나요	FALSE
거짓말 모 력 이름 교리 화 시켜서 정당화 아는 역사상 유일 무 이 황당한 사이비 ㅋㅋㅋ 이만 희 젊었을 때 정말 추하게 못 생겼더라	FALSE
예수님 못 생기고 학벌 없고 핍박 받아 죽기까지 했어요 창세기 계시록 세 책 안보 줄줄 말씀 하시는 분 지 파 창설 하시고 모든 교단 인신공격 당하면서 핍박 받는 지구 상 유일 무 이 하 신분 이	FALSE
핍박 받는 사람 궁 여자 들 응 응 하시는 군요 ㅋㅋㅋㅋㅋ 정신 차리세요 ㅋㅋㅋㅋ 신천지 사회 악으러 이미 판명 났어요 ㅋ	FALSE
그럼 왜 구 속도 안되고 공 영 방송 불미 일로 뉴스 안 나오나요 말씀 없는 목사 님 들이수 십년 동안 성도 들 퍼 뜨 린 루머 일 뿐입니다 진실 말씀 들 어보 직접 확인 하세요 작년 이 넘는 사람 들 왜 신천지 말씀 공부 수료 했을까요	FALSE
무슨 루머 ㅋㅋㅋ 공영 방송 나온지가 언제 ㅋㅋㅋㅋㅋ 피디 수첩 찾아 봐요 ㅋㅋㅋ 정신 나간 인간 ㅎㅎㅎㅎ	FALSE
피디수첩 신천지 대한 비방 거짓 보도 인정 건 왜 빼놓으시죠	FALSE
헐 잘 알지도 못 하면서 한국 교회 순 복음 아닌데 이 무슨 무 논리 교회 노인 들 다닌다고요 다 아는 것 이야기 하는데 실소 나네요	FALSE
비유 풀이 신천지 많은 곳 한다 하지만 신천지 다른 기 성교회 다른 것 예언 된것이 이루어진 실상 실체 있기 때문 예수님 가르침 뭔 지 아는것처럼 말 하는 당신 예수님 계시 받았나요	FALSE
이만 희나 전광훈 정명석 통일교 교주 예수 어차피 다 불 지옥 행 티켓 예약 동기 아님	FALSE
저런 걸 믿는 인간 들 뇌 어떻게 생겼을까	FALSE
사이비 신기하긴하다 영생 믿게하다니	FALSE
말장난 그래서 무섭지 집단 최면 그리고 사이비 믿는 사람 들 뭔가 내면 외부 환경 문제 있는것 때문 일것이고	FALSE
양심선언 안해 다 알 신은 허경영 거든 온갖 망신 당 음해 당 비웃음 당 감옥 갔다 와서 노래 만들어 나와서 소통 하려고하고 어떻 게 다시 나와서 또 알리 또 망신 당 그래도 웃기 려고 자신 망가지는걸 두려워하질 안잖아 오늘내일 하는 노인 들 어린 애 들 할거 없이 다 얼굴 지고 끌어안고 유튜브 강의 가끔 보는데 넘은 할아버지 이혼 해야 할까 요 물어보는데 내 당신 신랑 하더라 ㅋㅋㅋ 진짜 신랑 여기 있으니까 바가지 긁는 아내 두려워하지말고 죽 때 같이 살라 진짜 아닐까 싶다 이만 희 씨 사이비	FALSE
신천지 교인 들 이만 희 그 들 행위 악의 정형 보여주는 집단 일 뿐	FALSE
이만 희 과거 보세요 ㅡ 누구 하나님 믿고 따라다녔는지 ㅡ 그래놓고 자기 보혜사 니 자신 알고있지 부끄러움 모르는 사기꾼	FALSE
신천지 교주 여자 잘 선택 했군	FALSE
곱 늙어 죽어라 그냥 다 되가는데 내 연 녀 창피하지도 않니	FALSE
당연히 구원 자 예수 뿐 구원 이름 예수	FALSE
와 미쳣다	FALSE
성경 영생 말 예수님 영생 말씀 하셨습니다	TRUE
영생 말씀 하신 하나님 유부 남 결혼 주례 서 시진 않습니다 성경 어느 누구 하나님 주례 서 주신 적 없습니다 제발	FALSE
육체 영생 성경 없다	FALSE
네 예수 믿고 구원 받으면요 이만 희 믿고가 아니라 요 총 회장 예수 영 임 했네 어쨌네하 반응 넘 넘 기다립니다	FALSE
종교 중 개독 젤 시름	FALSE
페북 광신도 들 게시 물 엄청 올리던데 다 차단 했다 넋 빠진 인간 들	FALSE
역시 나약한 한 인간 이었구나 이만 희는 안타깝다 많은 사람 들 현혹 하 엿 는데	FALSE
팽당했 옆 꿀 빨다가 다른 애 밀렸나 보군	FALSE
제발 정신 들 차리시길	FALSE
늘 반복 되는 사이비 도대체 신도 아닌 교주 따르는 사람 들 뇌 구조 어떻게 생겼을까 신 아닌 죽 사람 의지 하는 어리석음	FALSE
그걸 겪어 봐야 아 딱하다	FALSE
십사만사천 이 들 자격 요건 있네 ㅋ ㅋ ㅋ 동정 이 여야 된다 개 나소 가 아니라 ㅋㅋㅋ	FALSE
이런 걸 믿는건 그냥 자기 이만 희처럼 되고 싶은 욕망 있어 서다 인간 다 죽는다 뭘 더 기대하냐 한심한 것 들	FALSE
이만 희 회장 님 우상숭배 하는 것 뿐이 아니라 지 파장 직접 교육 할 때 사전 예의범절 아멘 등등 얼마나 사람 대하 충성 강요 하는지 나 부정 적 보나 성경공부 시켜 줄라 하는 점 긍정 봅니다 단지 계시록 주인공 이만 희히 장님 하는 것 절대로 안 믿습니다	FALSE
한 때 교주 내 연 녀 호의호식 하다가 이제 와서 왠 일이 참 이상한 뭐 뒤틀렸을까	FALSE
대 깨 문교 비 하면 신천지 귀엽지	FALSE
댓글 신천지 신도 들 많이 몰려왔네 당연히 총 출동 하겠지	FALSE
그럼 교주도 평범한 인간 특별한 존재 생각 하는거 자체 이미 비정상 아님 근데 어차피 그 쪽 인간 들 다 눈 뒤집혀있는 상태 별 의미 없을듯 등 칼침 안 맞게 조심하시길	FALSE
종교 가장 사악하고 교활한 신천지 사 기 집단 인한 이사회 피해 너무도 심합니다 우리 모두 관심 가지 실체 파헤쳐서 이 사회 암 덩어리 몰아내고 건전한 가정 지켜야 합니다	FALSE
신천지 이만 희나 전광훈 똑 같은 넘 들 아닌가	FALSE
Kaix 신천지 너무 티 나잖아요 ㅋㅋㅋㅋㅋ 댓글 공부 좀 하고 오세요 ㅋㅋㅋ	FALSE
교주 들 참 여자 좋아해	TRUE
이단 정통 어느 종교 든 성직자 교주 계명 계율 얼마나 준수 하는가에 판단 되는것인데 돈 권력 인기 명예 탐하고 여자 탐하는 무리 들 절대 참된 종교인 아닌것을	FALSE
성경 우리 주는 깨달음 모든 인간 한없이 불완전하고 죄 많은 존재 들 본인 들 완전무결 하다고 주장 하는 오만 독선 가장 경계 해야하는 대상 결국 부자 가난 한자 살인자 목사 신 앞 별 차이 없는 평등 신약 죄 사해줄 방법 성령 잉태 완전한 예수님 죽음 통해 본인 들 구원 받을 수 없었던 죄 대한 대가 치뤄주었고 이를 믿는 것 구원 약속 것 개신교 일요일 주일 지키는 것 이를 따라 이단 들 돈벌이 수단 변질 되면서 이 단 출현 반복 되고 있으니	FALSE
근데 뭐 한기총 보니 예수교 장로회 별반 차이는 없는것 같다	FALSE
너희 안 이 마음 품으라 곧 그리스도 마음 오늘 아침 이 성경 보게 하시더라 하나님 창세 모든 계획 세우시고 그 하신 말씀 이루시고자 성경 천년 동안 일해 오셨으며 그 안식 할 것 말씀 하셨다 하루 천년 천년 하루 그 마침표 계시록 그 하신 말씀 끝 통치 하신다는 것 모두 바라던 바 그 기다림 끝 하나님 의 하신 말씀 이 세상 흘러 왔다 그러나 그 하신 말씀 성경 보는 자 안 보는자 로 갈림 그 또한 마지막 심판 하나님 뜻	FALSE
문빠 종교	FALSE
아직도 이런 사이비종교 믿는 정신 나간 사람 들 있 남	FALSE
거기 후 겨자 문제 ㅋㅋㅋ	FALSE
저걸 이야기 하는 사람 사이비 놀아나는 사람 길 바닥 도를아냐고 붙잡는 사람 에구 시간 아깝다 적당히 미쳐야하는데 이건 신념 놀아나니 약도 없잖어	FALSE
근데 유대교 볼때 이 세상 모든 기독교 전부 이단 아님 그런 기독교 누 군 이단 하고 안 하는것도 좀 웃기 기는 함	FALSE
인간 너무나 나약한 존재 스스로 살 생각 들 안 하고 의지 하려한 다 그러나 한낱 저딴 노인 네 믿느니우리 강아지 섬기고싶다	FALSE
교도 들 뇌구조 기대 된다 영생 불사 염병 믿는 종자 들 더 웃긴다 원숭이 뇌 수준 떨어지는 가보네 참 기독교 혹셍 수민 해서 개인 치부 하는 인간 말종 천국 전 미친 훈 종자 들 유병언 종자 들 저 종자 들 모두 신도 들 돈 뜯어내는데 혈안 된 인간 말종 들 저런 종자 자자손손 생전 모든 암 걸리고 마취 안되고 수술 번 씩 받고 지옥 같은 삶 살았어면 좋겠 ㄷ 네	FALSE
신천지 문제 문슬람 종교 생겻다 거기 제 정신 아닌 인간 들 많다	FALSE
국민일보 패스	FALSE
사이비 OUT	FALSE
신천지 전도 할 때 제발 거짓말 좀 하지 마세요 거짓말 몸 박혀있어요 숨쉬는거 다 뻥 듯 정말 무섭고 소름끼쳤어요 몇 년 이지나 잊혀지지 않네요 고등 친구 여러 명 달라붙어서 달 공 들이더라고요 중간 알아차리길 망정 ㅜㅜ 당당하게이만 희가 재림예수 믿어 봐라 왜 말을못해	FALSE
신천지 하면은 말씀 없는 목사 님 들이 수 십년 동안 이단 성도 들 세뇌 시켜서 아예 들으려 하지 않기 때문 말안하는것 입니다 말씀 들 어보 그러는것이지 악의 없어요 들어 보고 아니다싶으면 안 들으면 되구요 성경 폐하 못 하나 하나님 말씀 받은 사람 들 신 하셨거든 요 신천지 성경 믿습니다	FALSE
뭐 악의 없어요 사람 하나 잡으려고 직장 포기 하게 만들던데요 복음 방 가 들어오게 하려고 야간 하는 직장 못 가게 하던데요 어렵게 잡은 직장 였는데 이 기회 아니면 안된다구 이 악의 없는건 가요 일거수일투족 감사하는게 악의 없는건 가요 성경 이만 희가 요한 안나옵니다 ㅋ ㅋ ㅋ	FALSE
저 빠져 나오느라 힘들었음	FALSE
그건 좀 오해 깊으신 듯 선입관 편견 폭력 됩니다 교주 vs 인류 큰 용서 사랑 보 분과 쉽게 비교 하시는군요	FALSE
사기꾼 여자 잖아 여기 서도 사기치네	FALSE
하나같이 개천 똑같은 소리 하는지 울어 무 이 다니는데 듣기 싫은 말 한기총 시켰다 성경공부 하는거말곤 아무 것 강요 하지 않는다 강요 안하겠지 알아서 받치게만 드는데 ㅋㅋ 지긋지긋하다 개천 ㅡㅡ	FALSE
횡령 튄 주제 ㅋㅋㅋㅋㅋㅋ	FALSE
신은 없다 천국 지옥 죽음 두려움 이용 종교 장사치 들 이만 허구 일 뿐 현실 즐기며 충실히 살 그게 천국	FALSE
신천지 곳 모두 이 단 사이비 입니다 현재 국내 사이비 이단 신천지 너무도 많습니다 치료 가능하다고 하니 의 성경 치료받으시길 바랍니다	FALSE
너희 아무리 이단 외쳐 대도 신천지 성도 들 늘어나는건 진리 말씀 이 곳 나오기 때문 의 성경 너희 사람 계명 있을 뿐	FALSE
작년 신천지 포교 공 부방 하마터면 빠질 뻔 성경공부 중 질문 못 하게 끝 따지니 다음 부터 오지 말 인천 무슨 운동장 이상한 이름 행사 하고 직장 신천지 회원 한 명 있었는데 차원 이니 차원 이니 따돌림 공부 빠질 때 첨 이 사람 들 개 소리 잼있었는데 정신 안 차리면 빠짐 첨 신천지 얘기 안 어느 교회 다니냐고 물으면 대충 건너 뜀 개 소나 선교사 함	FALSE
신천지 이단 사이비 입니다 어제 존존 님 유튜브 영상 봤는데 충격 적 근데 또 신천지 측 뭐 찔리는 건지 신고 해서 내려갔더라구요 ㅎㅎ	FALSE
왜 내려갔을까요 찔리는게 아니고 거짓말 진실인 마냥 올렸기에 내려갔을꺼라고 생각 못 하시나요 뭐눈 뭐 보인다는게 딱 맞는말인거 같아요	FALSE
사이비 신천지 인해서 결혼 만에 파탄 날 지경 입니다 ㅠㅠ pd 수첩 같은데 제보 해서 제대로 한번 밝혀주세요 제발 부탁드립니다 응원 할께요 화이팅	TRUE
신천지 인해서 결혼 생활 파탄 났을까요 자신 행동 파탄 났을까요 정말 제대로 밝혀 줬음 좋겠네요 하나님 나라 상대로 거짓 전 했을 때 그 행동 결과 본인 책임지는 겁니다 예수님 십자가 못 박으며 그 핏값 자신 후대 물겠다는 유대 결국 역사상 가장 가슴 아픈 학살 이어졌죠 말 행동 책임 따른다는거 기억 하세요	FALSE
신천지 가르치는게 맞는지 안 맞는지 다른데가서 좀 알아보세요 신천지 말 드 확인 확인 좀 해보라구요 확인 해본 사람 들 모두 운 물안 개구였다고 하네요	FALSE
신천지 진짜 끈질겨 진짜 무서운 곳 왜 그러고 살까 주위 퍼트 려 주세요 신천지 무서운 곳 진짜 싫어 ㅠㅠ 쓸데없는데 시간 낭비 왜 하노	FALSE
나 종교 믿는 사람 들 자체 이해 안감 종교 믿어서 무슨 깨우침 얻고 마음 편해지나 내 가봐 온것 들은 오히려 안좋은 것 봤지 그리고 믿고싶음 너 거 들 끼리 믿어 괜 한 사람 개수 작부 리지	FALSE
후계 자 될려고 했는데 안되니까 내 연 녀 했나 보네 다른데 서는 돈떼 먹고 고발 당했다고 하던데	FALSE
뭐 구원 자 게 어딨어 다 사기꾼 수법 종교 종교 사기꾼 종교 구세주 구원 자 파는 것 기독 중 개신교 이슬람교 등 대표 적 그래서 종교 사기꾼 들 이를 모 방해 지가 마치 그런 능력 있는 것 조작 하여 계속 해서 수많은 신흥 교 만들어 사기 치 그런 것 종교 꾀임 넘어가거나 현혹 되면 인생 가정 재산 몸 모두 다 빨려 망하게 되어 있지 난 그런 종교 사기꾼 흔해서 그 런가 하지만 그런 것 종교 믿는 사기 당하는 사람 들 이해 불가 미쳐서 그 런가	FALSE
이 아줌마 사기죄 고소 당했다고 알고있는데 아닌가	FALSE
신천지 몰입 목회자 들 포함 수많은 신천지 성도 들 고민 해야 할 시점	FALSE
교주 영생 불사 웃고 갑니다 신천지 많이 이상하네	FALSE
이마 늬 나이 들어서 김남희 버림 받은 주제 계속 기어 나오네 ㅉㅉ 신천지 제일 윗 대가리 불륜 거리 낌 없이 저지르니 그 밑 것 들 안 봐도 뻔하다 불륜 아버지 불륜 선지자 유재열 오평 호의 따까 리 이마 늬 신천지 맹도들 이마 늬 성경 예언 이룬 자라고 떠들어 제 끼 추대 하 불륜 종 불과한 귀신 들린 놈 은 이마 늬 죽음 해 되길 바란다 이마 늬 죽으면 맹도들 새 천지 이적 해서 김남희 빌붙어라 너 네 들 낸 헌금 반 김남희 갖고있으니 말 잘 하면 불쌍하다고 국밥 먹을 돈 받을 수 있을지도 ㅋ	FALSE
이만 희에게 예비 된것은 영원한 지옥불 기다리고있다 종교 가장 큰 덕목 사랑 희생 임 불구 가정 파괴 부모 자시 깐의 생이별 실현 이만 희는 지옥 신천지 반드시 격을것 그리고 이만 희 추종 세력 같은 열차 탈것 성경 다른 복음 전파 하지 말 경고 했음에도 터 무니 없는 영생 불사 가르치고 여자 남자 결합 나온 보잘 것 없는 인생 구세주 떠벌리고 다니는것을 보면 역겹다 영생 주 믿고 구원 받은 성도 들 갖는 트꿘 사탄 영 받은 이만 희는 지옥불 영생 체험 할것이다	FALSE
김남희 마리아 자매 님 응원 합니다 다시 주님 로 돌아오세요	TRUE
신천지 있다가 신천지 돈 떼어 먹고 더 이상 궁지 몰리니 인심 공격 하고 ㅇ	FALSE
하나님 일하 심 기대하고 감사합니다 하루빨리 돌이키고 피해자 들 사죄 용서 구 하세요 늦지 않았습니다 신천지 실체 밝히시고 불쌍한 영혼 들 그 사이비 집단 더 이상 빠지지 않도록 또 그 곳 이미 빠진 사람 들 다시 나와 하나님 올바르게 섬기도록 힘써주세요	FALSE
이 세상 구원 자 자기 부모 없다 부탁 하면다 들어주거든	FALSE
이 걸 이제 서 알리 참 돈 다 뜯어 모아놓고 이만 희나 당신 똑같 애	FALSE
왜 피해자 들 고발 안 할까 저 남편 자식 버렸다는 여자도 믿어야 하나	FALSE
신천지 세무조사 해야 한다	FALSE
신천지 는 대화 필요없다 신천지 는 존재 자체 해악 바이러스 고로 화염방사기 와 대 전차 로켓 화기 와 유탄발사기 로 쓸어 버리는것 외 달리 방법 없어	FALSE
이쯤 되면 국정원 이만 희 암살 해야 되는거 아닌가	FALSE
버림 받은자 그 할 다음 일	FALSE
휴 참 가지가지 한다 된 노인 네 그걸 이어 받아 교주 되것다고 하는 내 연 녀 그 나물 그 밥 찐 개 찐	FALSE
천국 지옥 없어 멍청이 들 죽으면 썩어서 흙 되는거야 이 걸 인정 못 하 천국 지옥 그딴 거나 믿고있지	FALSE
그걸 모르는 국민 들이있나 이만 희가 사기꾼 줄 모르고 당한 신도 들 개 무식하거나 바보 들	FALSE
이만 희 늙은 놈 오늘 내일 다 안해 디진다 얼릉 지옥 가라 만 희야 안녕	FALSE
이만 희가 죽으면 뭘 포장 하려나 ㅋㅋ	FALSE
저런데 빠진 인간 들 있는데 신기하다 ㅡㅡ 시킨다고 예 예 따르는 골 빠진 사람 들	FALSE
신천지 신도 들 존존 tv 김남희 증언 영상 봤다면 바로 빠져나올텐데 안타깝네요	FALSE
이 기회 문 닫으시도록 코로나 쉬쉬 하게하더니 난리 아니네	FALSE
전광훈 관계	FALSE
우상숭배 하지 마세요 하나님 사랑 때론 엄 하 신분 그 맘속 하나님 영광 감사한 맘 없고 다른 어떤 것 우상 된다면 그 맘안 성령 거 하지못하 심 자만 착각 교회 다니면서 그런게 보 넘어졌지만 그래도 전 묵묵히 믿음 버리진 않네요 시 천지 믿음 다니니 그것 또한 우상숭배 보이네요	FALSE
이제 서 당연한 소리 하고 앉았니 ㅔ 믿었던 호구 들 응 세기 사셨나	FALSE
국민일보 드뎌 하나 건졌 네 얼마나 목말 했을 까느네 들도 똑같다 무조건 호식 거리 찾는것 들	FALSE
세 내 연 녀 있다니	FALSE
청년 들 이만 희는 가짜 제발 신천지 빠지지 말아라	FALSE
님 개종 목자 말 들으신 거 같습니다	FALSE
ㄴ 노답 신천지	FALSE
우리 딸도 신천지 나가고 나서 가족 보리 잡 나갔는데 신천지 악독한 사이비 집단	FALSE
소 읽고 외양간 고치	FALSE
이런 기사 사회면 톱 올려줘야지 가정 가족 버리고 사이비 빠져든 정신 빠진 인간 들 그리고 아래 댓글단 모 지리 정신차리고 세상 똑바로 살아라	FALSE
이만 희도 죽는다	FALSE
너무 당근 빠 따루 징	FALSE
저런 종교 빠진 인간 들 이렇게 많다는게 신기하다	FALSE
가정 파탄 났어요 아들 돌아와 제발 학교 가라	FALSE
강사 님 들 이 젠 그만 하소 양심 고백 할 때 되었는데 하기야 그 자리 어떻게 올라갔는데 벌써 알 있었잖아 그만할 때 됐다 불쌍한 신도 들 그만 놔두고 회개 주님 품 정말 지옥 간다	FALSE
돈 챙기는 목사 성폭행 사기 살인 저지른 전통 교회 목사 믿는게 더 정신 해로운것 같습니다	FALSE
돈 죽 자리 챙기는 이만 희는 괜찮나 봄	FALSE
jy 헐 목사 믿는게 아니라 하나님 믿는거죠 아니 누가 목사 믿어 교회 다닙니까 목사 어차피 당신 똑같은 사람 때론 죄 짓고 사는데	FALSE
남 희 누나 pd 수첩 한번 나오세요 공 영 방송 나와서 한번 진실 밝혀야 이만 희 교주 새끼 가슴 움켜잡을것 같은데 군대 빡쎄 한번 보여줍시다 불침번 세우고 하라 구 응원 할께요 화이팅	TRUE
나미 대표 님 더 파급 력 있는 방송사 양심선언 어떠세요 불쌍한 신도 들 생각 해주시고 지금 주님 품 오셔서 다행 입니다	FALSE
종교 때문 가족 해체 되고 사회생활 문제 생기기 시작 하면 그 종교 잘못 된거 임 사이비 종교 다단계판매 하시는 분 들 묘 하게 비슷한 부분 있음	FALSE
신 천지인 들 이만 희가 죽으면 그 걸 신천지 끝 말 하지만 이만 희의 추악하고 거짓 된 과거 행적 밝혀지던 이만 희가 죽던 안타깝게도 신천지 계속 유지 될것 입니다 왜냐하면 신천지 아직 성경 완 전 히 해석 되지 않았고 성경 해석 진 행 중 가르치기 때문 입니다 즉 이만 희가 죽었을 때 신천지 성경 마지막 해석 세상 핍박 받고 구원 자 하늘 승천 하였다 해석 하면 끝 이기 때문 이지 이미 신천지 이만 희 사후 치밀하게 준비 했습니다 아쉽게도 일이 너무 커져 버렸습니다	FALSE
사이비 신천지 인해서 결혼 만에 파탄 날 지경 입니다 ㅠㅠ pd 수첩 같은데 제보 해서 제대로 한번 밝혀주세요 부탁드립니다 응원 할께요 화이팅	TRUE
정신병 자 들이 아니 고서 어찌 어디 성경 가정 버리고 유부녀 이혼 시켜 제 마누라 삼 는단 말	FALSE
에고 신천지 있는 분들 정신차리세요 저 친구 믿다가 집안 다 무너지고 마음 상처 누구 털어놓지도 못 답답하네요 이제 그만 정신 차리시고 회개 하시지요 가족 받은 상처 죄 되지 않을까요 ㅠ 정말 하나님 믿는다는 분 들 하나님 두렵지도 않으신 가봅니다 정말 힘들게 글 써서 올립니다 이글 보신다면 제발 지금 나오셔서 돌아가십시오 더 늦기전에 말 ㅠ	FALSE
신천지 사 기 집단 그 만 들 나오십시요	FALSE
신천지 모든 거짓말 위장 교회 어떻게 저런 사이비 구 원자로 믿을수있지 정신병 마음 의병 크자 들이다	FALSE
늙은 미친 영감 빠져 인생 파탄 내는 사람 들 지금 제 정신차리고 휴 멀쩡한 가정 주부 내 연 녀 만들어서 ㅁㅊ 마귀 손 빨리 벗어나길 예수님 팔 먹은 사기꾼 새끼	FALSE
둘 다 똑같아요 사리 사욕 눈 먼 두 애인 만남 모텔	FALSE
인간 공허함 그걸 미끼 사이비 집단 여기저기 짜집기 해서 성경 꼬여 젊은 인생 망 뜨 리 사이비 집단 그 죄 어찌나 큰지 정신차리시오	FALSE
김남희 씨 폭로 응원 합니다 이제 회심 하시니 다행 축하 합니다 이제 정상 적 교회 신앙 생활 잘 하시길	TRUE
이만 희가 구원 자면나는 하느님 신천지 병자 들 깨어나라	FALSE
갸 구원 자 지나가는 개 짓겠다	FALSE
근데 존존 티비 신천지 막은거 같은데	FALSE
저런 종교 왜 믿지 이해 안 간다 정말 헛 웃음 나온다 미친거 아니 고서 ㅎㅎㅎㅎㅎㄸㅇㅇㄴ	FALSE
이만 희는 여자 사냥꾼 교인 들 많이 많 이따 묵었을 것 미투 운동 좀 하지	FALSE
아마도 그럴듯	TRUE
우리 딸도 신천지 나가고 나서 가족 버리고 집 나갔는데 신천지 악독한 사이비 집단 입니다	FALSE
ㅋ 저걸 알려줘야 알다 단단히 미쳤군	FALSE
자 여기 얼마나 오염 되었는지 객관 적 확인 해보겠습니다 정상인 공감 신천지 비공 ㄱㄱ	FALSE
가짜 알 있었다 속이려고 작정 덤벼 드니 넘어가는거지 사기	FALSE
신천지 신 집단 저 여자도 신천지 축출 당 새 천지 종교 집단 만 사이비 같은 존속 뭐 자존심 강한 두 사이비 자강 두 사	FALSE
새 천 지도 조심하세요	FALSE
이단 말 아까운 사이비 입니다 논 할 가치 없는 그냥 사이비 집단	FALSE
계시록 개 소나 푸는데 신천지 넘 들은 지 들만 푸는지 안다 ㅋㅋㅋ	FALSE
김남희 더 정신병 자 부끄럽지도 않나	FALSE
제 생각 같이요	FALSE
종교 자유 있다 돈 목적 하면 사이비 종교 신천지 돈 목적 하는지 궁금하다	FALSE
부모님 돌아가시고 후회 하지말길	FALSE
여기 댓글 신천지 신도 들 많이 보이	FALSE
공 영 망송 이런 내용 팁 좀 해주지 시청율 쫌 될거 같은데	FALSE
이만 희는 구원 자도 하나님 아니다 사단 앞잡이 종 노릇 잇으니 불쌍해 다모 속지 내 길이 진리 참 생명 하신 주 예수 그리스도 영접 하십시요 신천지 멋 모르고 빠진 분들 이제 회개 하 고참 진리 주님 앞 돌아오십시오 천국 백성 되십시요	FALSE
이만 희가 내부 문제 때문 폐쇄성 키워 코로나 핵폭탄 터뜨렸다 당장 미필 적 살인죄 구속 해야 한다	FALSE
신천지 사라져라	FALSE
너 잘 해라	FALSE
신천지 이번 기회 사 그 리 이 땅 몰아내어야 한다 아님 어찌 이만 희 사기꾼 저렇게 많은 사람 들 인간 정말 나약한 존제 인간 약점 가지 사이비종교 만드는 년놈 들 사지 찢어 짐승 먹이 줘 야한다	FALSE
김남희 씨 제 의 이만 희 ㅡㅡ	FALSE
종교 가지 장난 치 마라 사이비 종교 목적 돈 돈 요구 않하면 사이비 조교 종교	FALSE
넌 이만 희 휴지	FALSE
이만 희는 연약한 인간 어떻게 그 신격화 할수가 있는가 그것 개월 교육과정 이런 것 볼때 북한 주민 들 불쌍하다 김일성 김정일 다 죽는것을 보면서도 그 들 우상화 있어니 세상 백 두 혈통 이 어디 있나 그 들 피 A 형 B 형 AB 형 않나 신천지 이만 희와 북한 김정은 이 빨리 죽어 야한다 그래도 이 들 신격화 한다면 그 들 정말 이 들보 더 어리석은 인간 왜냐면 속이는 자 속 는 자 들 똑같기 때문 이번 기회 신천지 한 인간 이만 희 교주 속 았 다는것을 깨닫는 계기 되고 김정은 이 놀라는것을 보자	FALSE
저 신천지 집단 오래 처음 부터 사이비 단 종교 였습니다 왜 신천지 하는죠 그건 뒈져서 세로 운세 상 용어 입니다 새신 하늘 천 땅 사이비 집단 멸망하라	FALSE
신천지 이참 소멸 되어야 한다	FALSE
구원 같은 소리 하 ㅋㅋ 내 가해 줄 구원 여기 여기 붙어라	FALSE
신천지 사람 들 부들 부들 ㅋㅋㅋㅋ 이마 니 죽어 시캬	FALSE
사탄 아 나도 이건 좀	FALSE
신천지 뭔 지 알 다 들 그러는거지 그리고 궁금한건 사건 왜 지금 올림	FALSE
이제 세상 말세 왔구나	FALSE
진리 변하지 안지	FALSE
한국 기독교 총 연합 회 교단 교회 들 일 제때 일본 천왕 참배 절하 군수 물자 비행기 사서 바치 청년 들 전쟁 터 보내고 교회 종 바치 게 종교 알아보세요 하나님 외 다른 신 섬겨 하나님 배신 했어요 십계명 어김 가만있지 마시고 직접 알아봐라	FALSE
기윤 실 기독교 이제 고령 은퇴 장로 권 사들이지만 대 순 복음 성도 들 피 눈물 기도 세워진 국 일보 대답 해봐 이영훈 나눔 평화 긍정 교가 순 복음 정신 아니면 조용기 최자실 불퇴전 기도 금식 영적 전쟁 방언 성령충만 순 복음 정신 진짜 기윤 실 뭐 하는 집단 어디 향 하는지도 분별 못 하는 지경 간거냐 한심하다 이영훈 무슨 보수 성향 유투브 찌라시 더 지력 낮은 국민일보 기자 들 니 보수 주의 뭔 아냐 애드먼드 버크 들어는 봤니 진짜 국민일보 해체 운동 해야하나	FALSE
사람 들 좋게 하랴 하나님 좋게 하랴	FALSE
빌라도 단도직입 적 물었다 “ 아무튼 당신 왕 말 아니오 이 말 듣고 예수 자신 이 땅 온 이유 설 했다 “ 내 왕 네 말 있다 나 진리 증언 하려고 태어났으며 진리 증언 하려고 세상 왔다 진리 속 사람 누구 내 목소리 듣는다 ” 요한복음 장 절 원 시시대도 아니고 종교 무슨 종교 종교 것 없습니다 종교 선량한 사람 들 눈 멀게 하여 죽음 길 들어가게 하는 범죄 저질르고 있는 것 입니다 종교 말 하는 자는 너 죽음 길 들어가게 하는 사탄 마귀 입니다 메시아 장 절	FALSE
하나님 예수님 성모 마리아 실제 라면 인간 세상 이 정도 혼탁 해지면 안될 일 하나님 인간 사랑 하는데 이딴 식 사람 들 끼리 대립 하는 걸 보는 걸 가만 두고 즐기는 게 신 신격 건데 사람 동물 자기 섬기고 따르는 것 이딴 식 대우 하지 않음 신 있다면 창조 물 끼리 서로 죽이거나 지배 하는 걸 보는 걸 좋아하는 사이코패스 다를 게 없음	FALSE
종교 아닌 것 들 단체 집단 세력 들	FALSE
전광훈 이 대표 가짜 뉴스 발병 지지	FALSE
먹 회 자 빋으 그런 멍청한 짓 어디 있음 빨갱이 선동 제 일 많이 하는게 목사 놈 들임	FALSE
신천지 out	FALSE
많다는데 핵심 주자 왜 많을까 깊이 있게 생각 걸 해보세요 머리 갖고계시면 태어나서 단 한번 깊이 는걸 갖고 생각 곳 쫌	FALSE
목사 들 성경 한 구절 제대로 알려줘 봐라 알지도 못 하면서 성경책 글자 그대로 해석 하니 돈 목사 들 누가 따르니 그리고 저렇게 무식한 목사 들 교주 교의 주인 말 하는것인데 예수님 이지 이 무식한 목사 저러니 사리 분별 청년 들 떠나지	FALSE
신천지 성경 한 구절 제대로 알려줘 바라 알려주면 신도 들 다 떠날 걸 ㅋㅋ 그래서 이 총 회장 교주 내 연 녀 김남희 씨 배 교하 새 천지 분파 차린거 아닌가	FALSE
제대로 알려주기 때문 안 떠나고 해마다 수십만 명 씩 입교 하는 겁니다 작년 수료식모르시나봅니다 넘쳐나는 이유 왜 일까 요	FALSE
뭐 는 거야 이만 희의 성경 영어 성경 한국 식 번역 어설픈 사기 불과하단다 한국 사람 들 속기 좋은 말로 짝짓기 해서 돌려막기 하는 전형 적 언어유희	FALSE
왜 목회자 들 바른 성 경 교육 시키지 못 하는지 본인 들 말 하고있지 않은가 비판 하기보다 목사 들 실력 갖추는게 우선 일듯 ㅠㅠ 이 우리나라 종교 현실	FALSE
왜 신천지 이만 희는 성경 교육 신천지 복음 방 교육 할 때 처음 속 가는데 왜 처음 부터 신천지 말 하지 않는가 신천지 거짓말 모략 전도 부터 그만하는게 우선 일 듯 ㅠㅠ 이 우리나라 사이비 현실	FALSE
모략 성경 온 단어 맞습니다 교육 중간 신천지 밝히는데 왜 떠나지 않고 교회 입교 하실까 요 왜 그럴까 요 이유 아신다면 님 입교 되실듯	FALSE
한 개웧 뒤 여기는 신 천 지다 말 했을 때 이미 세뇌 아닌 세뇌 당해있어서 그렇지요	FALSE
한국 교회 지금 바른 교육 하지 않았고 목회자 들 책임 의식 없다는걸 고 백 한 건가 그러면 지금 성도 들 무슨 교육 했다는 건지 궁금하네요 한국 교회 성도 들 실망 감 줘서 실족 하게 했다는것도 시인 하시는 건지 자기 말 스스로 올 무가 되는줄도 모르고 이단 정통 정죄 있다는게 재밌네요	FALSE
아직도 정신 나간 게독교 목사 들 때문 나라 힘들어지고 교 다 떠나는 현실 한국 기독교 총 연합 회 대표 하나님 까불면 나 죽어라고 할 정도 미친 목사 게 목사 거짓 목사 수두 룩 한 데 거기 참 하나님 계시겠니 젊은이 들 다 떠나는게 맞지	FALSE
아직도 정신 나간 사이비 맹 때문 나라 힘들어지고 신천지 내부 새 천지 분파 생긴게 현실 신천지 총 회장 이만 희가 난 육체 영생 한다하고 할 정도 미친 교주 거기 참 하나님 계시겠니 이만 희 내 연 녀 김남희 떠나는게 정상	FALSE
과연 기독교 신천지 욕 하 거나 비웃을수 있을까	FALSE
전광훈 이 한기총 대표 거기 이단 아니냐	FALSE
맞아 전광훈 이단 신천지 이단	FALSE
전광훈 따르는 순 복은 뭐	FALSE
전광훈 아무리 말 많아도 신천지 정당화 되지는 않아	FALSE
말씀 전 부인 신천지 해부 하기전에 기 성교 희 목사 들 정치 놀음 횡령 세습 성범죄 썩을 대로 썩은 현 기독교 부터 해부 해 보시	FALSE
한국 기독교 총 연합 회 교단 교회 목사 들 범법 자 명 데 미친 목사 들 거짓 교 속여 장사 있네요	FALSE
신천지 이만 희는 교인 수 명 되면 끝난다고 했는데 그 뒤 믿음 있는 명 말 바꿔서 끝 없는 장사 있네요	FALSE
끝난다고 하신 적 없는데요 역시 세상 목사 들 하는말만 맹목 적 믿는 불쌍한 분들 완성 시작 우리 그렇게 배우는데	FALSE
처음 이되 면 끝 했음 ㅋ	FALSE
역시 신천지 이제 지 들이 한 말 안 했다고 구라치는 구나 어찌 소경 빛 보리 대답 예 수 그리스도 보혈 능력 봅니다	FALSE
현재 우리나라 기독교 교회 성도 들 영혼 만족 시키고 있는지 생각 해 봅시다 성경 성도 들 잘 교육 시키고 있는가 교회 희망이 없다고 생각 합니다 부패한 교회 들	FALSE
성경 바르게 알 미혹 되지 않을것 같습니다 성구 하나 하나 풀어주시길	FALSE
이단 ㅡ 끝 다르다에요 하나님 시 작 해 사람 끝나고 하나님 시 작 해 돈 끝나는 집단 영적 분별 력 가지 경계 해야 합니다	FALSE
할말이 없으니까 괜히 천지창조 책 가지 별 트집 잡는거지 성경책 가지 말 못 하면서 ㅉㅉㅉ 저기 당당하게 성경책 펼치시지요 괜 책 가지 들 먹 거리 지말고	FALSE
저번 천안시 기독교 총 연합 회 신천지 천안 지부 토론 신천지 성경 보지 토론 하자고 했는데 ㅋㅋ 너 님 말 성경 보고 하자 신천지 싫다고 하던데 ㅋ	FALSE
기독교 자체 망상 아닌가 천국 지옥 최후 심판 종말 ㅋㅋ	FALSE
가만히 있긴요 말씀 없는 목자 들 이 책 인터넷 교회 성도 들 이단 가정 파괴 하 거짓말 퍼뜨리면 무차별 공격 있잖아요 교회 못 짓게 민원 넣어가며 막 고초 림때 서 기관 바리새인 들 똑같 은행동 있구 만요	FALSE
전도 하려면 속 이지 당당히 하세요 왜 그렇게 사시는지 궁금합니다 이만 희를 믿을 사람 믿게 해주시 사람 들 속 전도 하지 마세요 제발	FALSE
신천지 숨쉬는것 빼고 거짓말 이 면서 뭐 그리 잘났을까요 저 친구 거짓말 상처 많이 받고 사람 못 믿겠더라구요	FALSE
남 비판 하 그 비판 한 것 되 돌아 온다는 신천지 와서 공부 교회 가서 성도 들 가르치는게 낳을 듯 예수님 비유 말씀 하신것을 그 세 잊어버리고 자의 적 해석 하 안 돼요 안 돼 언능 신천지 오셔서 공부 좀 하셔요 단 단 하지말고 말씀 맞으면 믿고 공부 해야지 예수님 대언 사자 계 장 절 를 그렇게 매도 하면 나중 유황 불못에서 마귀 왕 하고 같이 싸우나 를 죽지 못 싫 컷 돈 안내 할수있다오 배워서 남주나 호랑이 잡으려면 호랑이 굴 들어가야지	FALSE
사이비종교 교주 들 그냥 사형 하면 안되나	FALSE
성경 자체 오류 투성이 뭘 가지 서로 이단 비난 하나 한기총 빤 쓰 목사 명성교회 세습 다 똑같은 놈 들 끼리 허상 세워 두고 천당 장사 하는구만	FALSE
이제 곧 끝날거 같습니다 남히가 폭로 했습니다	FALSE
신천지 일 반 교회 악의 무리는 있는 법 하나님 영광 감사 찬양 돌리면 분별 할수있는 지혜 주실꺼 하지만 그 맘 자만 악함이있는자는 성령 함께 하지 못 하 심 듣지도 믿지도 말길	FALSE
저 목사 자신 생각 풀이 성경 제대로 안 가르치는 교회 다니다 성경 한 권 풀어지는 놀라 움 신천지 가는것이다 청년 들 바보 저 목사 멍청한게 성경 봉함 되있다고 이사야 예수님 말씀 하셨는데 이만 희가 전 제한 다니 예수님 오셨을 때 구약성경 조목조목 짚었나 예수님 청 세기 구약 끝 순서 푸신 아니라 성경 한 구절 실상 나타난 것 이 말 응 한 것 라며 인용 하셨다 나를 보는 것 내 아버지 하나님 보는 것 했을 때 그 당시 종교인 들 예수님 죽이려 했다	FALSE
신천지 망상 빠진 집단 비난 하기에 앞서 니 들 개신교 단체 들 하는 짓 좀 생각 해보고 비난 해라 개교 회중 심주 교회 이미 목사 교주 형 목회자 되였어 나도 교회 다녔지만 특히 장로회 다녔는데 목사 자기 예수 줄 알더라 개 교회 중심 주의 공교회 사라지고 각종 비리 난무 하니 니 들 욕먹지	FALSE
그 특히 “ 교주 이만 희는 요한계시록 속 사도 요한 밧 모 섬 예수 그리스도 환상 본 현장 자신 있었다고 주장 다 ” 여기 거른다 ㅋㅋㅋㅋㅋ 신천지 교리 다른데 뭘 비교 한다는 거 자기 들 신천지 교리 만들고 그걸 비교 하려고 하고 있네	FALSE
무식한 목사 보아 너 하나님 믿는 넘 이 라면 하나님 그 하신 말씀 믿었을 것 하나님 영 그 하신 말씀 이루시기 위 하여 그 시대 들어 쓴 사람 있었다 우리 믿는다는 것 곧 계시록 약속 된 말씀 믿는다는 것 기록 된 바 예수님 천사 통해 사도 요한 지시 하셨다 하는 예언 서다 그렇다면 그 사실 보고 들인 목자 사도 요한 통한 증거 곧 하나님 하신 약속 이루어진 실체 또한 있을 것 아니냐 구약 신약 계시록 동일한 뜻 나타난 사실말이다	FALSE
어제 서 울 모 교회 장로 여성 명 성추행 고소 당했다고 뉴스 나왔어요 말씀 제대로 알 하나님 두려워서 그런 짓 못 해요 성경 나타난 신천지 핍박 받는건 당연하죠 사람 씨 아닌 성령 태어난 예수님 사람 생각 이해 가나 하나님 능력 부인 하시는 건가	FALSE
성경 많고 해설 서도 많고한데 교회 왜 가나 문맹 들 사도 바울 자가 교회 만들어서 예수님 얼굴 먹 칠 하고 있다 하늘 보시 한 심 할거다 ㅉㅉ	FALSE
얼마나 머리 비어 신천지 빠지지	FALSE
헐 얼마 전 어떤 놈 종이 드밀 동아리 어 쪄구 저 쪄구 하면서 잠깐 시간 내서 설문조사 해달라고 하던데 동아리 설문 조사 왜 길 하지 생각 못 들 척 지나쳤는데 이 인간 들 였구나	FALSE
목적 주소 전화번호 나중 어떻 게 연락 해서 포섭 하려는	FALSE
포섭 하는 여자애 들 몸매 이쁨 만나 보고 싶다 대 로 으흐 흐흐	FALSE
신천지 아닌 그냥 전문용어 사이비 맞는거 아닌 교	FALSE
기 생 충	FALSE
말씀 찾지 않은 신앙 인 사이비 된다	FALSE
인간 인간 일 뿐 자신 신 하는 자는 모두 사기꾼 엄마 아빠 관계 통해 태어난 썩을 육체 가진자는 모두 죽 수 없는 인간 일 뿐입니다 신은 전 지 전능 무소 불위 무소 부재 영생 불사 영원불멸 무 유 창조 시간 공간 초월 존재 입니다 이만 희가 이중 하나 속 하는지 잘 생각 해보세요 이미 예수님 영화로운 육체 부활 하셨기 때문 썩을 육체 가지 있지 않으며 가질 수도 없습니다	FALSE
전지전능하다면서 악마 이기 못 해 아직도 싸운다고 하던데	FALSE
비공 왜 누르긴 ㅋㅋ 예 수 타령 해서 비공 눌렀다 왜	FALSE
예수님 살아계십니다 하늘 계신 아버지 오른 편	FALSE
종교 얘기 ㅡ 잼 없어	FALSE
못 없애는 게 아니라 안 없애는 거	FALSE
남편 가진 권력 뺏고 싶은것 이상은 아닌것 같은데	FALSE
자신 속 았 다 지나가던 개 웃겠다 하지만 결국 신천지 교단 독 되고 자신 대다수 국민 득 되겠네	FALSE
남편 아니고 내 연남	FALSE
양심 고백 하시는데 악플달지 마세요 저 폭로 영상 보고 완전 정신차렸네요	FALSE
여호와 증인 하나님 교회 대순진리회 통일교 원불교 다미선교회 구원파 등 요새 이단 및 사이비 종교 들 판 친다	FALSE
함 부러 싸잡아 말 하는 것 몰상식한 행위 같네요 잘 모르면 이렇게 싸잡아서 여론몰이 안 어디 교 무엇 중요시 어디 잘 이해 안되 더 식 아닐까 요 영국 여왕 상과 국위 선양 많이하고 선한 모습 이웃 헌신 적 봉사 하는 하나님 교회 같이 싸잡아 논 하는거는 안 맞는거 같아요 잘 알아보고 말 하세요	FALSE
어이 없네요	FALSE
원불교 여기 넣는건 정말 무식하기 짝 없는거지 이미 개신교 카톨릭 불교 등 함께 한국 종교인 평화 회의 속 대 종단 중 하나고 신도 수로 번 째 종교 배타 적 무지하지다 보니 이런 댓글 싸지르고 다니지 ㅋㅋ 혹시 너 원불교 하는 일 차원 적 말 하지마라 그 정도 지능 낮진 않을꺼라고 믿는다 ㅋㅋ 난 원불교 정말 도 관련 없는 사람 너 못 배우고 배타 적 인간 설치는게 싫어서 지식 알려주는거야	FALSE
원불교 군대 있는 우리나라 대종교 이 무식한 멍 청아 대한민국 대통령 종교인 모임 하면 원불교 꼭 초대 다 삼성 이건희 홍라희 여사 원불교 종로 교 당 결혼 도하 이 멍 청아	FALSE
원불교 아님	FALSE
석가모니불 주 불로 모시는 불교 원불교 이 단 불교 불교 부처님 이 교주시 원불교 ㆍ 이리 사람 소태산 박중빈 교주 박중빈 이 교주 원불교 무슨 불교 불교 교주 꼭 부천 님 들 석가모니불 미륵불 노사 나불 등등 이어 야함 소태산 박중빈 불교 금강경 보고 조금 알음알이 얻어 ㆍ 원 ㆍ 자를 앞 붙여 원불교 함 원 할머니 보쌈 원자 붙였지 본 댓 글단 분 정확히하셨습니다 본래 이 단자 들 발끈 하 왜 이단 모르면 원사 정녀 물어보면답 나옴 자기 믿는 종교 역사 나기 원 알아야 참 종교인 원불교 역사 쯤됐음 불교 임 박중빈 이 불교 개혁 하려다 안되니 원불교 만들어 나감	FALSE
하나님 영국 여왕 상 받아요 가짜	FALSE
이만 희 보내고 자기 접수 할려고 하는구만	FALSE
신천지 기독교 아니다 그냥 수많은 사이비 종교 하나 일 뿐	FALSE
신천지 같은 이단 빠지지 않는 유일한 길은 무신론자 되는 것 종교 헌금 사기 그만두어라	FALSE
신천지 이단 즉 사이비 이만 희가 교주	FALSE
신천지 교주 이만 희를 비판 하면서 자기 교주 되려고 수작 질하는것 안 보이나요 ㅡ 저 예수님 오셨습니다 ㆍ 이 말 바로 자기 예수님 대행 알이잖아요	FALSE
자기 들 끼리 짜고치는데 판 깨려는 건지 나간건 맞지만 저 여자도 정상 아닌 상태 든데 가족 끼리 이 간질 시키는 집단 나도 아버지 대려가서 육년 시간 낭비 아버 진아 직도 다시오라고 십년 넘게 매 일 하루 종일 봉사 날 비난 다시 돌아오길 고집 해서 사이 좋아질수 없습니다 빨리 망해서 해체 되 길기 도합 니 무슨 영육 간 하나님 결혼 시켜서 육신 영원히 살아서 제사장 부귀 영화 부린다 판타지 같은소 릴 이런시대 믿고 현실 망각 하 고속 끌어 들이고자 기자 신 가족 헌신 짝 만드는 무서운 세뇌 집단 얼른 정신차리세요 전 나온 뒤 너무 자유 소중한 시간 보내고있어요	FALSE
증언 ㆍ 감사 감사	TRUE
모두 아는것을 저 신자 들 모르고 있었을 뿐	FALSE
신천지 때문 집 간지 아직 들어오지 않는 언니 ㅜ 빨리 신천지 사이비 깨닫고 돌아오길 바 보고싶다	FALSE
거 짖말이 아니라 거짓말 맞춤법 배우고 글 올리시길 회사원 거 짖말 거짓말 비교 못 하나 창피하다 ㅋㅋ	FALSE
개떡 말 해도 찰떡 들어라 무슨무슨 국어 시험 본 당가 이 문장 어디가 잘못 됐냐	FALSE
이만 희나 전광훈 도 찐 개 찐	FALSE
신천지 이만 희 구원파 유병언 영 세 교 최태민 오대양 박순자 천부교 박태선 여의도 순 복음 조용기 희 대의 사기꾼 들 비슷한시기에 만들어진 종교 들	FALSE
순복음교회 이단 사 입 집단 너 누구 너 성령 회방죄 ㅡ 똑바로 알고말해 성령 회방죄 사하 심 없다 했다 영원한 지옥	FALSE
모두 특정 지역 출신 들입니다 기 막히게 일치 합니다 국민 여러분 조심합시다	FALSE
smc 거품 물 인간 지목 한 거여 종교 껍데기 덮은 이빨 꾼 들 이단 결정 니 들 정 하구	FALSE
돈 막강 한 조용기 순대볶음 교 순대 볶아 돈 많이 벌었어 원 수도 사랑 하 종교 댓글 때문 지옥 신자 교육 안 시키고 순 대만 볶은 증상 광신도 양산 하지말고 참 교육 참신 자 답 교육 필요 ᆢ	FALSE
순 복음 순 가짜 빙고	FALSE
저런 걸 믿는 사람 들 이해 할수가 없다 종교 적당해야지 어느 종교 광신도 마냥 과 한 건 미친거 같다	FALSE
신천지 것 들 정신차리자 니 들 옛날 둘 불륜 내 말 할 때 니 들 뭐라 했어 마리아 예수님 관계 다 거짓말 영상 조작 나 욕 하지 않았냐 그럼 지금 거짓말 이나고 말 해보지 ㅋㅋㅋ 이 거 김남희 돈 때문 이러는거 내 봐도 그래 그럼 니 들 생각 걸 해야지 그 돈 이만 희가 준거야 횡령 이런게 아니라 횡령 맞으면 이런 언론플레이 해봐야 뭐 하는데 니 들 참 얼마나 생각 없는 사이비 맹 인지 좀 거울 보자 ㅋㅋㅋ	FALSE
신천지 OUT	FALSE
이 민희 대체 왜 믿지 아 휴	FALSE
길가 돌아다니며 말거는데 무서워요 뭐 보인다나 염병 사이 비교 진짜 없어졌음 좋겠어요 법 어찌 안되나	FALSE
저건 다 김남희 교 돈 빌려 달라 하고 몇십 억 사기 쳐서 들통 나서 쫏겨 겁니다 알아봐라 다 거짓말	FALSE
이만 희가 가평 연 수원 김남희 명의 해주었는데 그거 신 천지인 들 알 가	FALSE
그렇게 해준게 아니라 김남희 안 수작 부린 겁니다 제발 똑바로 알 말 하세요 그렇게 말 하면 두렵지도 않습니까 신앙 인 되었으면 사람 말 현혹 되지말고 진짜 진실 알기 위해 노력 답 하세요 안타깝습니다	FALSE
신앙 인 머 니 자기세계에 빠져서 교만해져서 거짓말 사람 속이는게 무슨 신앙 추수 같은 소리 한다 세뇌 되서 이 기적 자기 이득 보려는 이상한 심보 똥 가득 찬 거짓 선지자 정도 일것이다	FALSE
당신 지금 한 말 심판 받을 겁니다 보이지 않는 곳 말 함부로 하지 마세요	FALSE
안상홍 흙 일어나기라도 한다는 말 정신 차려 어리석은 자 예수님 부활 하시고 승천 하셨다 안상홍 죽어 땅 묻혀 썩어 흙 돌아간 인간 일 뿐	FALSE
신천지 망하겠구나	FALSE
신천지 정말 무서운 사람 들	FALSE
이만 희도 다른 이단 들 전혀 다를 바 없지요 신천지교 이 사회 봉사 한다고 하지만 결국 눈가 리 아웅 하는 것일 뿐 바퀴벌레 징그럽지만 신천지 사회 혼란 하게 하고 가정 붕괴 시키니	FALSE
ㅋㅋ 신천지 이런 사이비 종교 빠진 사람 정신 세계 문제	FALSE
빤 스 있는데 말다 했지 광화문 보세요 빤스 연설 하면 눈 뒤집어까 구 이상한 신음 소리내구 가관 입니다 빤스 추종 무리 몇십 만 될 겁니다 거기 내는 돈 폐지 줍는 노인 분들 도 왔으면하는데 빤 스 같은것 들 호의호식 시키구 통탄 스럽습니다	FALSE
머 니 이 새끼	FALSE
요 위 놈 주둥이 확 찢어줄까	FALSE
신천지 조심하자	FALSE
초대교회 진리 말씀 아닌 사람 계명 가르치고 행 하는 교회 성경 기준 하나님 보기 모두 이단 입니다 성경 없는 일요일 예배 크리스마스 추수감사절 성모마리아 십자가 세우는건 물론 교회 내 금전 거래 교회 부자 세습 단 파벌 짓는게 왠 말입	FALSE
이혼 보혜사 사람 아녀	FALSE
이만 희 죽고 나서 이야기 해라	FALSE
ㅂ 신천지 들 ㅉㅉ 진짜 바퀴벌레 같은 것 들 하찮은 것 들 정신차려라 쪼글쪼글한 할배 따위 무슨 구원 시켜주냐 ㅎㅎ 진짜 아무리 생각 해도 ㅂ 신천지 들	FALSE
딴 여자 생겼나 보네	FALSE
김남희 거짓말쟁이	FALSE
통일교 신천지 감옥 보내자 이단 아웃	FALSE
도대체 신 왜 믿는거 임 내 앞 나타나면 믿겧 신 처음 각 본 연출 한 사람 들 그런 부분 빠져 나갈 믿 밥 만듬 신은 인간 볼수 없다 착해야 천국 간다 하늘 계신다 하늘 왜 있고 뭐 하며 존재 이유 뭐 구지 선 악 구분 하여 천 당 지옥 나누는 이유 뭐 그 곳 가면 언제 있어야하고 형체 죽은나이 때 인간 유지 되는 건지	FALSE
사이비 교주 들 사형 시켜 버려야 돼	FALSE
힘들게 육아 하는 애 엄마 들 접근 해서 나도 애 엄마 하면서 잘해주고 이 것 저 것 챙겨주다가 신천지 만들어 버림	FALSE
여자 말 하는것도 이상해 그냥 저쪽 말 다 이상해	FALSE
신천지 조금 관심 보이 얘 들 무지 끈질기게 달라붙어요 확 때리지도 못 하겠고	FALSE
신천지 우리말 새누리 ㅡ 누가 새누리당 만들 엇 더라 ㅎㅎㅎ	FALSE
노컷뉴스 전광훈 편 드냐 한기총 이단	FALSE
전광훈 편 적 없는거 같은데 근거 대시 무조건 음해 하지 신천지 식 사고방식 버리시요	FALSE
우두머리 싸움 여 남자 불리 합니다 근 디 권력 맛보면 여자도 독해 집니다 서로 때리면서 만든 교주도 여자 정신 들 차리세요 제발 실체 없는 하느님 예수 부처 놀아 나지 마세요 받치는 돈 영화 보고 어려운 이웃 한 번 처 보고 무료 급식 주세요 교회 절 사이비 종교 전부 그 늠 들 밥값 술값 노름 값 오입 값 여 저 것 들 다 구멍 우리 똑 같은 것 나오는 인간 이유	FALSE
파탄 가정 진짜 많습니다	FALSE
돈 여기저기 빌린것이 아니고이만 희가 김남희 이쁘다고 수십 억 백억 이르는 돈 재산 준것 임 그리고 이제 서 김남희 되돌려 달라 소송 건것임	FALSE
신천지 그렇게 가르치고 있구나 ㅋㅋ	FALSE
이만 희 김남희 조희팔 희 희 희	FALSE
사이비 신천지 인해서 결혼 만에 파탄 날 지경 입니다 ㅠㅠ pd 수첩 같은데 제보 해서 제대로 한번 밝혀주세요 부탁드립니다 응원 할께요 화이팅	TRUE
pd 수첩 같은데 제보 해서 제대로 한번 밝혀주세요 부탁드립니다 응원 할께요 화이팅	TRUE
무었 믿던 본인 자유 입니다 하지만 기독교 던 카톨릭 같은 건가 불교 던 무엇 진실 입 죽은 외국 귀신 들 섬기며 성경 불경 머리 좋은 인간 집필 했을것이고 엄청난 사기 극 외국 귀신 섬긴답시고 자기 조상 귀신 제 사 도안 지내는 허허 어떻게 이해 해야 할지 종교 자체 본인 의지 약해서 기댈 곳 필요한 사람 들 집단 이렇게 말 해봐야 빠진 사람 들 나 이해 못 한다고 하겠지	FALSE
조 상신 섬기는것 외국 머리 좋은 학자 쓴 내용 토대 하는 것 대단하고 특별한거 없음	FALSE
영혼 황폐 하게하고 사회 도덕 상식 ㆍ 인륜 하나님 이름 말살 시키는 사이비 교단 앞 얼마나 더 인간 사고 인성 말살 시킬 건가 불안전 한 인간 이기 혹 꼬임 너 어가 불행 자처 한다 불쌍한 신자 들이어 엉뚱한 집단 빠져나와라 제 의 유병언 종교 된다 지금 쯤 이만 희는 유병언 지옥 허 벌나게 혼사 있당 이만 희 ㆍ 유병언 죄명 갈취 ㆍ 사기 ㆍ 공갈 ㆍ 가정 파탄 등등 ᆢ	FALSE
아인슈타인 ㅡ 종교 인간 이만 가장 큰 발명품	FALSE
댓글 봐라 ㅋ 역시 신천지 X 신 천지 들	FALSE
살아계신 예수님 사랑 저 들 이끌어 줍시다 잘못 된 길 나올수 있도록 도웁시	TRUE
위낙 교활한 신천지 있었으니 검증 해 봐야겠죠	FALSE
신천지 전 광훈 이나 빤 스 천지	FALSE
이 거 신천지 신도 들 빠져나온 갓 처럼 대 한 북한 교회 들어가서 신천지 물들이게 할려는 큰 그림	FALSE
자기 들 끼리 해먹 다음 권력 넘겨주는거지 한 통속 임	FALSE
자칭 보혜사 이혼 스켄들 휘 말렸네 ㅋㅋ 신도 갈라 설땐 재산 문제 골치 아프구나 이럴 땐 이만 희는 지도 사람 하겠지 신 합일 했다고 불리하고 골치 아플 땐 사람 변신 교리 참 사람 입맛 맞게 잘 만들었네 ㅎㅎ	FALSE
이또 말 안됨 어떻게 몇 년 함께 살면서 이제야 실체 폭로 하겠다고 나섰다는 자체 꿍꿍 이 있는듯 지금 신천지 피해자 그 들 김남희 탈퇴 통해 더 이상 피해 보지 않고 올바른 판단 하길 바랍니다	FALSE
사이비 빠지는건 정신병 자임 의심 해봐라	FALSE
김남희 새로운 주인 되려 하는구나	FALSE
노컷뉴스 거짓 나부 랭 하나님 때려 죽인다는 너거 전광훈 교주 님 해명 해	FALSE
어쩌다가 이단 발 담군 분들 제발 정신 찬 리세 예수님 말씀 묵상 하시고 양 딸 쓴 이 리 속지 마세요	FALSE
신천지 때문 기독교 박살 거	FALSE
화면 보면 대통령 영부인 줄	FALSE
아 짜증나는 신천지	FALSE
근데 신천지 하나님 까불면 죽 빤스내려 내 여 신도 그 곳 자식 대대손손 대형 교회 물려주고 재산 불리는 먹 사들이나 다 똑같은 사이비 집단 임 사이비 빠져 아멘 하며 돈퍼주 지옥 가는 신도 들 재산 뺏 겨가며 앞 그렇게 사시길	FALSE
종교 간략 설명 하나님 예수님 성모마리아 섬겨라 천주교 하나님 예수님 섬겨라 기독교 부처님 섬겨라 불교 알라 섬겨라 이슬람교 내 교주 신 나를 섬겨라 이단 종교 통일교 신천지 여호와증인 등등	FALSE
여호와증인 이 단 이기 철두철미 성 서 준수 현 상황 같 등 야기 하는게 문제 되겠죠 지금 대체복무 있지만 집 총 거부 같은거로	FALSE
tisr 그 성서 지 들 입맛 해석 한 거임	FALSE
tisr https://namu.wiki/w/ 여호와 증인 문제점	FALSE
천주교 성모마리아 믿는거 아니에요 예수님 낳아 둔 엄마 공경 하는 겆 신격화 그러지 않아요	FALSE
이단 엄청 나게 많네요 이 단보 신도 들 엄청나던데	FALSE
교주 신격화 하는 종교 사이비 스스로 허 늘 통 한다고 지껄이는 놈 사이비	FALSE
이만 희가 성경 모르는것에 기 참 어서 들 나오세요 신천지 무슨 완전 사이비 입니다	FALSE
왜 기사 이 거 안나 실검 같은데라도 올랐으면 좋겠다 더 퍼져야 맞는 것 같은데 ㅎㅎ 빼도 박도 못 하는 관심 증거 있어도 발뺌 하는 신천지 특성 상 이번 기사 들 흐지부지 되 버리면 이런 상황 또 어떻게 이용 해서 본인 들 유리하게 할지 모르니까 ㅋㅋ 예전 네이버 베스트 도전 신천지 옹호 하는 웹툰 연재 되 기도 했었는데 진짜 가리는 것 없이 활동 하는 집단	FALSE
모든 종교 허구 존재 증명 되지도 않은 것 들 믿고있으니	FALSE
이천 잇 눈데 매주 수 일욜 차 주차 할 곳 없어서 길가 세워 둠 ㅋㅋㅋㅋ 무슨 머리 빠지는 건지 놀라운건 대도 있음 ㅋㅋㅋㅋㅋ	FALSE
신도 한 푼 받아 쳐 먹는것 들은 모두 사이비	FALSE
신천지 새누리당 단체 입당 건 어떻게 되었나	FALSE
광신도 집단 이 넹	FALSE
사실 확인 후 글 쓰고 있나요 노컷뉴스 실망 입니다	FALSE
실망 무슨 이 신 천지인 들 다른 사람 들 괴롭게 하지 마라	FALSE
신천지 새누리 종교 정치	FALSE
하나 미치면 정신병 집단 미치면 그것 바로 종교	FALSE
이 시대 소위 반일 기준 아무리 장덕수 명문 장 였다고 해도 친일파 불과할 걸 일제 핍박 고생 있어야 식민지 백성 일본 유학 갔으면 친일 해서 잘 먹고 잘사는 집안 틀 맟춰 하니까	FALSE
사회 주의자 들 그냥 북 가라	FALSE
동아일보 힘내세요	TRUE
동아 초심 때 하 곤 너무 많은 때 탔다 ㅋㅋ 원래 이러지는 않았을텐데 남북전쟁 많이 도 변질 됐다 좌빨 먼저 탄생 했고 우 꼴도 그렇게 기생 하 듯이 탄생 했다 그리고 지금 조중동 중 동아 창립 자의 정신 훼손 있다는걸 알 창립 자 무덤 울거다 ㅎㅎ 안 그래 수꼴 들	FALSE
동아 만세 응원 합니다	TRUE
이 시대 동아일보 같은 언론 있어 정 말 다행 ᆢ 동아일보 화이팅 ᆢ 당신 들 땜 그래도 힘 납니다	TRUE
기사 제목 어그 오지 ㅋㅋㅋㅋ	FALSE
김일성 추 켜세우는 꼬 라지 들 ㆍㆍㆍ	FALSE
지 들은 잘 하면서 이런다냐 좌 빠리 네 들 역대 최악 이 당 어디서 선동 질	FALSE
■■■■■■■■■■ 친일파 역적 이자 남로당 빨개이 다 까 끼마 사오 한국 이름 박정희 를 숭상 하는 틀 따 구들 알 보니 알밥 들이었어	FALSE
지는요 토요타 다쥬 존경 헌 당	TRUE
누가 뭐라 해도 네 들 뻘갱이들 나으니까 괜찮다 이마큼 먹고 사는게 누구 덕인 지나 알 씨부리던가 뻘갱	FALSE
중궈 공산당 ㆍㆍ 중대 만세 ㆍㆍ	FALSE
동아일보 박수 보냅니다	FALSE
조중동 니 썩 꺼지라 햄 니 들 좋아하는 꼰 대 마인드 ㅋ	FALSE
뻘갱이들 싫어하는거 보니께 조중동 애국 있었 당	FALSE
긴 세월 이어 온 동아일보 애쓰셨습니다 진영 가치관 서로 다른 사람 들 사는 사회 속 호응 받고 거 센 비난 맞아가며 언론 포기 하지 않고 끝 자리 지켜주셔서 고맙습니다	FALSE
우리 머리 좋은 지도 층 원하는게 아니야 뜨거운 맘 국민 안아줄 그런 사람 필요한거지	FALSE
동아일보 감사합니다	FALSE
노력 등골 빼먹는것이 일상 화 된 좌빨 들	FALSE
자화자찬 어느 정도 필요한 말이렸다 하나 반 성과 성찰 통해 성장하고 지지도 받는것 아닌가 친일 권럭 유착 언론 사명 망각 민족 국민 독자 실망 좌절 준 일 없는지 고백 자성 필요하지 않을까	FALSE
대 깨문 들 지 들하고 다르면 다 토착 왜구 권력 취한 기득권 들 민중 마음 아니라 하더라 대체 그런 오만함은 어디서 나오는 건지 지 들만 깨 시민 줄 착각 오 짐 결국 비판 할줄 모르는 사이 비신 같은 것 들 웃기지도 않음	FALSE
그렇듯 창 대 창간 뜻 품은 동아 일보 백년 후 정권 개 되고 나팔수 자처 하는 참담한 지경 이르고 아마도 장덕수 선생 지하 편히 눈 못 감고 통곡 하시리라	FALSE
현재 동아일보 창간 취지 맞는 방향 가고있는지 참으로 의문 요 펜끝 형성 된 그 아무 것 아닌 권력 취해 그걸 잃지 않으려 아둥바둥 하며 세상 호도 하고있진 않는가 자문 해보길 바랍니다	FALSE
그 말 옮겨 적지 그 뜻 옮겨오시구 랴	FALSE
문제 썩은 정신 손 들어주는 민주당 폭 망하리라 반칙 아니면 절대 영원히 아웃	FALSE
친일 신문 말 많구나	FALSE
모라 구러는거냐	FALSE
그니까 그렇게 훌륭한 선배 들 두고 니 들 왜 그 모 냥 ㅋㅋ	FALSE
거의 만에 다시 읽었는데 여전히 불후 명문 입니다 자유 주의 침해 되고 있는 상황 더욱 마음 와 닿는군요 장덕수 선생님 너무 빨리 갑자기 돌아가셨지요 안타깝습니다	FALSE
이 좀비 들 지 들만 인간 지 들만 정의 지 들만 눈물 있고 지 들만 약자 배려 한다고 깝 치는 덜 떨어진 소아 병적 자기 중심 적 머 저리 들 만화책 읽어 남 들 다 악마 단정하고 지 들이 주인공 인양 의기양양 깝 친다 까 보면 지 들이 더듬고 성추행 지 들만 특권 특혜 누리 죄다 친일파 후손 주제 반일 선동 한다 위선 가득 찬 기생충 들	FALSE
창간 사는 그럴듯하고 그 중간 그 뜻 맞게 유지 디 ㅢ 던 기자 들 있었는데 지금 순전히 조중동 쓰 네 기 중 끝 있나 기왕 쓰레기 될꺼면 동 중조 되도록 하지 이제 시대 종이 쪼가리 의존 하던 시절 갔으니 이 제 그만 불 살라 버리고 해체 해라 동아	FALSE
오욕 점철 된 동아일보 의 역사 모르는 사람 있을까 폐간 답일 진대 왠 견성 인지 모르겠다	FALSE
창간 좋았고 손기정 선수 일장기 가린 기자 편집자 패기 좋았지만 신문사 그 사람 들 잘라 버리죠 이후 친일 신문 거듭 열심히 매국 앞장서다 반성 없이 지금 이어져 현 세대 또 하나 권력 더티 권력 부역 자 충실한 동아 입니다 다음주 저널리즘 토크 쑈 J 를 보세요	FALSE
빨갱이 우한 코로나 없는 사회 국민 들 안전하게 살수 있기를	TRUE
이런 귀한 자료 실어 줘서 감사합니다 더 귀한 자료 발굴 해 알려주세요	FALSE
참 좋아요 참 고마워요	TRUE
일본 식 한자 쓰기 끝판 왕 ㅡ 글 문장 자신 정체 성 나타냄을 알어라 ㅡ 풉	FALSE
얼마 전 신천지 전단지 봤는데 전부 전광훈 명성교회 세습 이런 얘기 들 도배 되어 있더라 신천지 같은 사이비 막는 제일 효과 적 방법 신천지 가지 마세요 백 마디 하는 게 아니라 정통 교회 부패 해결 하는 게 아닐까 싶다	FALSE
말씀 들어 보세오 절대 이단 아닙니다 성경 속 시원하게 풀어주는 곳 이 신천지 왜 이단 이라 하는지 이해 안가네요 이교회 저 교회 보아 도 닿는게 없어 서무 신앙 있다가 신천지 온 사람 입니다	FALSE
요한복음 장 절 말씀 이 곧 하나님 하셨는데 말씀 없으니 즉 하나님 함께 하지 않으시니 무너지는건 당연한 겁니다 앞 더 가속 화 될것 입니다 청년 들 없으니 불보듯 뻔한 일 아닌가요	FALSE
전광훈 한기총 회장 관리 해라 똥 온몸 쳐 발라놓고 누굴 손가락질 하는지 ㅡㅡ	FALSE
신천지 이만 희나 전광훈 뭐 똑 같은 종교 집단 안보 인	FALSE
전 지인 사주 보러 가자면서 상담 가를 소개 시켜주던데 상담 안 이런저런 이야기 하다가 생년 월일 받아 감 그러고 며칠 뒤 다시 나서 사주 상담 그동안 어디서 알아가지고 온듯 그 뒤 자기 가치관 교육 어쩌 하면서 성경 알려주겠다며 앞 몇번 더 만나자 함 여 튼 이런 식 꼬시는데 그냥 성경공부 하자고 하면 무조건 조심 난 솔직히 그 지인 신천지 생각 하지만 계속 아니라고 발뺌 자기 소개 받은 사람 지금 멀리 있는 중 여 튼 친한 사람 조심 특히 최근 급 친해지는 사람 특히 조심	FALSE
신천지 만나서 센 타 서 말씀 공부 하 사람 천복 받은 사람 입니다이 밝은 세상 뭣 두려워서 그러시나요 말씀 들 어보 아니다 싶으면안 나가면 되요 ㅎ 말씀 맞는데 신천지 공부 하다가 그만두는 사람 들 많아요 안타까울 뿐이죠 말씀 이 하나님 데 말씀 동행 하면 든든해요 ㅎ	FALSE
한국 기독교 총 연합 회 교단 교회 목사 들 범법 자 명 이라네요 ㅡ 이 게독교 현실 입니다 이단 누가 만든 건지요 한국 기독교 총 연합 회 교단 교회 들 일 제때 일본 천왕 참배 절하 군수 물자 바치 청년 들 전쟁 터 보내고 게 종교 대표 전광훈 목사 하나님 까불면 나 죽어라고 하는 것 사이비 이단 한국 기독교 총 연합 회 교단 교회 입니다 교 직접 알아보세요 왜 목사 말 믿고 성 경 말씀 안 믿나요 지옥 갑니다	FALSE
한기총 마귀 자식 들 하나님 자식 위장 함	FALSE
외부 유출 금지 이 핵심 신천지 全 문건 외부 유출 엄격히 금지 하 거든 교회 구약 신약성서 공부 하는게 기밀 붙일 일인 암튼 교회 구약 신약성서 공부 하 는걸 기밀 붙여야 한다고 나댄다면 신천지 포함 사이비종교 집단 일 가능성 다 뉴스 기사 잘 보고있음 ㅋㅋ	FALSE
신천지 한기총 순 복음 너 네 끼리 싸우든 말 관심 없다	FALSE
이만 희만 때려 잡아 죽이면 된다	FALSE
이미 죽었어 임마	FALSE
안 죽었는데 뭔 솔	FALSE
남 말 듣지 마시고 말씀 받은 목자 하시니 그 분과 직접 대회 해 보시 막말 하든 말 하세요 어르신 이건 아닌것 같네요	FALSE
현재 우리나라 제일 부패하고 타락한 교회 어디 일까 대형 교회 전광훈 세속 교회 너희 들 그 들 나오는 콩고 물이 아쉬워 그 들 보면서도 따라가는 입장 아니냐 입은 삐 뚫어 졌어도 말 바로 하자 돌대가리 목사 위장 교회 실제 하나님 말씀 바로 가르치고 그 정도 걷는 것 이 라면 그 곳 간판 무엇 무슨 상관 사도 바울 집 거리 감옥 그 어떤 장소 시간 관계 없이도 그 하신 하나님 말씀 전 했다 하나님 말씀 곧 살았기 때문	FALSE
신천지 드라마 같은 거짓말 들 정말 무섭다 그렇게 거짓말 해야하는 곳 왜 목숨 걸고 가는 건지 ㅠㅠ 너무 안타깝다	FALSE
그냥 양 아치 사기 집단	FALSE
일체 교회 들 신천지 다 잡 때 잠시 휴 관해 야하는거 아닌가	FALSE
이런 좋은 기사 있나요 정말 좋은 정보 입니다 신천지 로부터 기독교 지킵시다	FALSE
기독교 자체 사이비	FALSE
정통 교회 가면 전광훈 같은 놈 목사 별 그지같은 놈 들 성추행 교회 대물림 하이고 신천지 대형 교회 저 주안 받냐	FALSE
진짜 남일 아니라 걱정 입니다 어머니 때매 이마 죽음 나오신다 약속 했는데 위장 교회 갈까 바 휴 진짜 ㅜㅜ	FALSE
신천지 그렇게 무섭나요 말씀 뿐 신천지 혈안 되서 견제 하는것 보 하나님 말씀 무섭긴 하나 봐요	FALSE
신천지 X 신 천지 들	FALSE
우리엄마 돌려 놔라 똥 같은것 들	FALSE
신천지 안젛은건 전 국민 아는거고 그러면 개독교 개 목사 님 중 하느님 동 기 동창 분 어떤 분 궁금하네 개독교 개 목사 들 하느님 아님가 삥 뜯어서 지 들 잇속 챙기는거 보면 누가 누구 욕 하는 건지 종교 허울 쓰고 그러지 좀마라 마약 무서운게 종교 쟁이	FALSE
참된 기독교 성경 완성 된 후더 이상 계시는 없다는것 입니다계시를 받았다고 주장 하는 사람 사이 비료 보면 틀리지 않습니다	FALSE
만 희 이 놈 선명 이 조만간 지옥불 잘 타겠네 ㅋㅋㅋ	FALSE
나이 먹으니 총명 흐트러집니 당 연 이긴 자라며 쯔쯔 사람 처음 신 될수 없습니다 돈 명예 내려 놓지 못 하는데 욕심 나은 자업자득 마니야 지금 양심 고백 어때 로펌 들 등뒤 고생 하는데	FALSE
Jms 도 파헤쳐주세요	FALSE
정신 나간것 들만 이 기사 모아놓았구먼 도 찐 개친 끼리 모 뭔 이단 ㅎㅎㅎㅎㅎ 성경책 맞을 사람 들 ㅎㅎㅎㅎ	FALSE
이 무슨 생활 문화 뉴스 한 종교 단체 다른 종교 단체 꼬투리 잡아 깎아 내리는 얘기 구먼 이런 밥그릇 싸움 왜 네이버 뉴스 대문 봐야하나 네이버 이런건 대문 걸어주지 말아라	FALSE
네 다음 신천지	FALSE
국민일보 팥 메주 쑤든 어쩌 상관 없는데 네이버 뉴스 대문 보기 싫다고 말귀 못 알아듣네	FALSE
kjw 그러면 단체 가 아니면 뭔 화학물질	FALSE
용 식이 사 단 의자 식 마귀 자식 누구 말 믿어야 하는가	FALSE
이상한게 국민일보 왜 이 곳 기사 낼까 꼭 돈 먹은것처럼 나 그렇게 생각 하나	FALSE
돈 쳐 들여서 광고 하는 신천지	FALSE
국민일보 ㆍ CBS 는 게독교 신문 몯 믿지 돈 이 거짓말 기사도 다 내고 신천지 한국 기독교 총 연합 회 목사 들 만나서 토론 하자고 신천지 말 했는데 한국 기독교 총 연합 회 목사 들 안 만난다며 왜 성경 모르니 쪽팔리지 저러니 청년 들 다 떠나지	FALSE
신천지 빠진 사람 들 전부 정신 병자 들 입니다 종교 빙자 사기 집단 맞습니다	FALSE
아무리 훌륭한 교리 무장 하더라도 사람 섬기는 종교 끝 좋을 수 없다	FALSE
개신교 불교 한국 국민 이 라면 누구 종교 자유 갖 수 있습니다 어느 종교 더 좋다 나쁘다 할 수 없죠 개개인 선택 사 항일 뿐	FALSE
불교 고타마 싯다르타 기독교 예수 태양 신교 니므롯 담 무스 등등 토템 이즘 샤머니즘 동물 해 달 나무 도깨비	FALSE
문 천지 교	FALSE
대 깨문 신천지 다를게 뭐 얼마나 멍청하면 이러는거냐 다행히 내 주변 신천지 대 깨문도 없다 본인 멍청한지도 모를 정도 멍청함 외로워 이러나 ㅉㅉ	FALSE
기독교 신천지 여호와 증인 남묘 호랑 교 뭔 놈 종교 들 이리 다양한지 하긴 일본 원숭이 신 도 있다더라	FALSE
전광훈 신천지 낫 않나 하나님 가지 노 벼락 안 맞은거에 감사해야 지그 밑 있는 한기총 목사 똑같지 ㅠ	FALSE
창조주 왜 약속 하시고 이루시면서 증거 하시는지를 알아야 한다 약 속 내용 아는 방법 모르는 신앙 인 이단 된다	FALSE
사람 하나님 될 수 없지만 하나님 사람 모습 얼마 오실 수 있죠 예수님 단 기 사 내용 성 경 예언 없으면 잘 못 된 집단 거	FALSE
이 세상 모든 종교 다 사람 섬기지 뭘 섬기나	FALSE
인간 예수 인간 몸 입은 신 믿는 너희 이만 희를 신 믿는 저 놈 들 뭐 다르며 더 완전한 존재 믿고 추구 하기 위해 신 무형 존재 만들어 거기 다가 질투 화 내고 벌도주고 때론 사랑 도하 상도 주는 인간 성향 부여 해서 그걸 믿는다고 하는 너희 도대체 뭐 다르고 뮈 더 나은거냐	FALSE
이 거 딱 대 깨 문두 하는말	FALSE
예수 사람 아님 석 가도 사람 알라 사람 사람 아닌 걸 섬기는 종교 뭐 있음	FALSE
불교 내 부처 되기 위해 석가모니 롤 모델 삼는 깨달음 종교 입니다 내 극진 가라데 배운다고 최배달 모시 롤모델 성불 하자구요	FALSE
그니까 하느님 믿어야지 목사 믿으면 안된다니까 ㅋㅋ 목사 신 생각 하는 사람 들 많음	FALSE
신천지 탈퇴 자 들 양심선언 응원 합니다	TRUE
저 여자 분 안전 걱정 되네요 문제 생기 신천지 짓 ㅠ	FALSE
이 기사 곧 좌표 찍히고 난장판 될 것 같은데 아직 은 안 보이 넹	FALSE
나 속 서 신천지 다녔었는데 거기 전도사 내 군대 야한다 좋은데 취업 해야 한다니까 하나님 복음 더 급하다면서 군대 취업 다 미루라고 하더라 ㅋㅋㅋㅋ 자기 네 들 서 들으면 나중 빌게이츠 자기 십일조 낸다고 ㅋㅋㅋ 그거 듣고 감 와서 손절	FALSE
간 친하게 지낸 대학 동기 신천지 알고서 얼마나 소름 돋았는지 동안 코스프레 하다사 아는 형 선교 활동 어쩌구 잠깐 시간 내서 도 달라 앞뒤 안 맞길래 느꼈지 애 참 착한 친구 누가 제 동기 좀 구원 해주세요	FALSE
기독교도 양심선언 하자 예수 개구 라다	FALSE
예수님 개구 였으면 얼마나 좋겠 읍 그런데 진짜 워쩝	FALSE
예수 게쇠끼 해봐	FALSE
거짓 하나님 믿고 있는 한국 기독교 총 연합 회 교단 교회 목사 들 양심 있나요 한국 기독교 총 연합 회 교단 대표 하나님 까불면 나 죽어라고 하는 것 거기 하나님 없다는거죠 교 생각 좀 해 바보 들 같이 있지말고 직접 보고 확인 성 경안 신앙 해라	FALSE
아무리 잘 나가던 유명인 과거 범죄 의혹 나오면 그 말 신뢰 잃게 된다 김남희 씨 이미 법적 범죄 사실 인정 되었고 아직도 진행중 것 많다고 들었다 cbs 노컷 언론 사이 면서 범죄자 말 신뢰 하도록 유도 있으니 바른 언론 자격 없다고 본다	FALSE
사기 자기 쳐서 재판 받고 있으면서 누구 보고 사 기 집단 말 불법 횡령 사기 친 것 들 재판 결과 곧 다 나올텐데 오늘 사는 사람	FALSE
어휴 여기 신천지 들 많네	FALSE
문 빠 들 수준 신천지 밈 종교 미치니 답 없음 ㅋㅋㅋ	FALSE
드디어 정신차렸 다기 이미 알고있었을듯 돈 권력 여러가지 때문 쉽게 못 놓았던거겠지	FALSE
영생 누린다고 멀쩡한 사람 들 파멸 시키고 지랄 하는 사이비 종교 하나님 팔아서 인생역전 하고있는 사이비 이만 희 교주 가정 파탄 학업 중단 시키는	FALSE
애초 하나님 어딨냐 신천지 교회 거기 거기 지 들 끼린 자기 들 빼곤 이단 어쩌 아주 웃김 ㅋ 남 들 보기 신천지 기독교 통일교 구원파 다 똑같은 의지 박 약자 들 집합소	FALSE
김남희 유다 프레임 씌우겠지	FALSE
예수 게쇠끼 해봐 ㅋ	FALSE
창조주 왜 약속 이루시면서 증거 해 주시는지 알아야 한다	FALSE
신천지 나쁘다 없어져야 한다	FALSE
교회 비교 할수가 없죠 영업 이익 내 기 위 하 하는 행위 입니다 식당 회사 하는 것 이	FALSE
눈 보이지 않는 이 들 무슨 말 할까 세상 이렇다 저렇다 뭐라 설명 할까 고 조선시대 사람 들 스마트폰 뭐라고 표현 해야 할까 사기꾼 말 그대로 믿는 너희 들 성장 이유 뭔 지 똑똑히 보여 드릴게요 두 눈 크게 뜨고 지켜보세요 곧 당신 손가락 후회 하게 될 것 입니다 잘라 버리고 싶을 만큼 말 입니다	FALSE
신천지 나쁘다는 말 어떤 기준 성경 안 신앙 하시고 거짓 보도 속지 마시고 직접 알아보세요 바보 CBS 보도 믿지말고	FALSE
ㄴ 사이비 댓글 쓴다고 수고 하네 ㅋㅋ 댓글 모음 기 찬다 ㅋㅋㅋ	FALSE
사도 요한 왜 배도 자를 알아보지못하는가	FALSE
신천지 이만 희 대 노인 하나님 신격화 하는 어처구니 없는 사이비 집단	FALSE
저기 신천지 이만 희를 하나님 안해 어떻게 해서든 나쁘게 몰아가려고 애쓰시네요 이만 희 님 하나님 예수님 교주도 아닙니다	FALSE
하나님 예수님 교주도 아닌 사기꾼 이지	FALSE
이 긴자 한다네 ㅎ 누굴 뭐 이겼나 세상 사기 이겼나	FALSE
거짓말 유포 하지 마세요 하나님 하나님 신 사람 사람 입니다 신천지 누구 사람 신 하지 않습니다	FALSE
사기꾼 자기 사기꾼 안 한단다 ㅋㅋ 멍청해서 그 런가 ㅋㅋ 사기꾼 씨부리는 곧 이 곧 대 로 쳐 믿네 ㅋㅋㅋ	FALSE
사이비종교 특징 다단계 몇 명 데려와 야한다 개인 자유시간 억압 한다 나갈려고 하면 엄청난 연락 한다 특정 금액 지속 적 강요 한다 남 들 자신 들 소속 숨길려고 한다	FALSE
번 빼고 기독교 똑같네요 제발 교회 다니라고 강요 좀 하고 다니지 마	FALSE
번은 전혀 아닐텐데 사이 비애 들 자랑 말 하던데	FALSE
번 전도 번 성경공부 주말 예배 새벽 기도 등 번 헌금 비슷한듯	FALSE
신천지 기독 다른 점 강요 하지 않는다 가 팩트	FALSE
문빠달창 비슷하네	FALSE
궁금한게 그렇게 대단한 종교 왜 사람 들 접근 할 때 무슨 설문조사 심리테스트 본인 들 신천지 말 못 함 무슨 회사원 말끔 하게 입고 대학생 들 뒤 두 세명 씩 끌고다나면서 길가 사람 졸졸 따라다니는거 보여주면서 말거는거 교육 시킬 때 개 한심해 보임 본인 들 인생 시간 낭비한다는 사실 본인 들 모르는거 같아서 개불 쌍 신 천 지애 들 모 뭐 홍보 지 들 끼리 뭉쳐서 돌아다니는거 보면 얼굴 무슨 사 명감 뿌듯함 느껴하는데 경찰 오면 깨갱 하고 어따 전화하느라 바쁨 안타깝다 증말 이 거 반대 하는 사람 신천지 일듯	FALSE
특히 도를 아십니까 이런 사람 들 더 심하다는거 계속 졸졸 따라다니면서 말 걸고 싫다는데도 말 걸고 조상 님 어쩌고저쩌고 하면서 얼굴 복 많으시네요 잠깐 얘기 좀 할수있을까요 막 이러면서 돈 뜯어가는 수법	FALSE
진짜 공감	TRUE
떳떳하지 못 하니까 ㅡㅡ	FALSE
기사 보다보다 어이 없어서 댓글 남겨요 ㅋㅋㅋ 하나님 한적 없는데 왜 혼자 그렇게 생각 하시고 사실 마냥 말씀 하시는거죠 ㅋㅋ	FALSE
그래서 예수님 이만 희가 같다고 주장 하니 성경 예수님 구원 자 천하 다른 이름 없다고 분명히 적혀있어 마귀 새 ㄲ 들아 처음 끝 거짓 만들어진 집단 비유 풀이 니 들 사 기수법 다 들어 났는데 ㅎ	FALSE
구약 여호와 밬 구원 자 없다고 했습니다만 흠 흠 사 장 절 하나 알 둘 모르시네요 각 시대 구원 자 있는 겁니다	FALSE
누가 봐도 정상 적 못 사기꾼 집단 맞습니다 저희 회사 남 직원 중 두 명 아내 시 천지 빠져서 가출 해서 돌아오지 않고 그중 한 명 을 기다리다 결국 어린 자식 둘 있는데 이혼 했습니다 하나님 가정 화목 하게 하고 더 사랑 하며 살라 하시는 분 가정 깨면서까지 교회 다니라고 하실 분 아닙니다 교주 이만 희란 사람 신천지 다니는 사람 평생 죽지 않는다는 교리 때문 본인 죽 병 걸렸는데 거짓말 드러날까 말 못 무당 불러 몇 억 짜리 굿 했다고 신천지 있다 나온 어떤 사람 얘기 해줬다더군요 ㅎㅎㅎ	FALSE
인류 절반 사기꾼 나머지 절반 거짓말쟁이 이 걸 아직도 모른다면 바보	FALSE
하나님 아니라 하느님 바른 표기 입니다	FALSE
하느님 인간 만든것이 아니라 인간 하느님 만들었다	FALSE
하느님 하나님 영어 하면 똑같이 god 히브리어 하면 똑같이 엘로힘 뭘 쓰든 상관 없다고 ㅋㅋㅋ	FALSE
애국가 하느님 보우 하사 하느님 크리스찬 들 말 하는 그 하나님 그럼 우리나라 사람 다 크리스챤 하느님 하늘 계신 신 일 컸는 거고 크리스챤 들 말 하는 하나님 하나 뿐 없는 유일신 일 컸는 거임 즉 하느님 하나님 뜻 다름	FALSE
이 년도 교주 놈 같이 어리석은 신도 들 유혹 해서 십 수년 간 빨대 꽂고 빨다가 이제 교주 수 틀리니 사이비 구원 자 아니니 폭로 ㅎㅎ 바보 아니 다음 처음 이만 희 사 기 행각 모를 리가 없었을 터	FALSE
원래 악 착한 사람 아니라 싸움 진 악인 잡는 거	FALSE
됐고 나 바란다 이만 희가 빨리 죽기를 왜 고 그 래야 부활 안 하나 보고 신도 들 등 돌릴테니까 본인 참 하나님 안 죽고 영생 한다는데 어디 한번 두고 봅시다	FALSE
통일교 문선명 죽었어도 아직 건재 하 쟎 어 한번 빠지면 헤어 나오기가 참 힘들죠	FALSE
다른 이단 방법 롤 모델 쓸 겁니다	FALSE
많은 사람 들 신천지 왜 빠지냐고 하는데 실체 알 누구 예외 없다 수십 명 한 명 끌고가기 위해 설계 완벽하게 한다 나 남편 신천지 빠진지 이 넘어가면서 신천지 대해 제대로 알 됐다 이만 희가 죽지 않을거라고 찰떡 믿고 있는 기 막힌 상황 수 없는 가정 눈물 흘리고 있는걸 알까 일 반 교인 들 믿지 않는 사람 들 온갖 탈 쓴 신천지 악랄한 무리 속지 않기 위 해서는 제대로 알 대처 해야 한다	FALSE
저 노인 네 하나님 믿는 사람 들 효	FALSE
신천지 속 는 사람 들 정신차리세요	FALSE
ㅂ 신천지 들 정신차려라 이 희는 니 양말 빤 쓰하나 사 준 적 없다 거기 나갈 시간 니 부모 남편 마누라 아들 딸 돌봐라 걔 그냥 쪼그라든 대추 같은 할배 너 네 절대 구원 시켜주지 않아 ㅂ 신천지 들	FALSE
신천지 이만 희는 없어져 야한다 선량한 가정 파괴 범 대한민국 사법 개혁 공 수 처 설치 동시 정통 교회 불교 천주교 기독교 만남 기고 나머지 전체 해체 시키고 패쇄해 국민 건강해진다	FALSE
니 들 혹시 부칸 하자는건 아니겠지 문 달신 섬기 자고 ㅋㅋㅋ 문 달신 달 궁전 어서 방부제 미이라 만들고 이러는거 아니겠지 염려 스럽다	FALSE
emrl 상또 라이 같은 소리 치아 건강한 시민 한마디 니 썩은 뇌 수준 생각 하지마라	FALSE
여기 공수 처가 왜 나옴 ㅋㅋㅋㅋㅋㅋㅋㅋㅋㅋ	FALSE
신천지 광신도 들 조국 광신도 들 똑같다	FALSE
심각한데 큰 병 같네요	FALSE
태극기 부대 같겠지	FALSE
어디 비교 하는 자기 자신 뒤 돌아보세요	FALSE
이성 되찾으신 것 축하 드립니다	FALSE
이성 되찾 은 아니라 후계 자 구도 즉 돈 싸움 져서 쫓겨난 겁니다	FALSE
전 국민 다 아 는걸 무슨 폭로 씩 ㅋㅋㅋㅋㅋ 그냥 니 들 끼리 알아서 들 해 ㅋㅋㅋ	FALSE
사이비 신천지 이만 희와 김남희 후계 자 구도 놓고 싸우다 김남희 쫓겨나자 김남희 바로 폭로 해 버린 겁니다	FALSE
아이고 이제 깨 달아서 다행 입니다	FALSE
신천지 가정 파괴 범 종교 사기꾼 집단 맞습니다 지금 수많은 젊은이 들 그 들 꾀임 넘어가 가족 버리고 창창한 인생 포기 있습니다	FALSE
신천지 죽일 것 같은데 신변 보호 해야하는것 아닌가	FALSE
길거리 보육원 있는 아이 들 메세지 적어 달라 것 들 다 신천지 임 그 연락처 애 들 답장 왔다며 만나서 답장 주면서 편지 봉사 하자 꼬드김 그러면서 슬슬 작업 들어가는데 놀라운건 그 답장 사기 에고 그 아이 사연 사기 임 그 아이 존재 자체 허구 ㅋㅋㅋ	FALSE
팽당하 바로 까 버리네 ㅋㅋㅋ 인간 쓰레기 들 믿는것은 자유 하지만 선량하고 아무 죄 없는 착한 사람 들 유혹 하여 인생 파탄 나게 만드는 악의 종자 들 ㅋㅋ	FALSE
유튜브 신천지 홍보 영상 한번 보세요 사지 육신 멀쩡한 젊은 여자애 들 청년 들 티아라 롤리폴리 노래 틀 시내 춤추며 신천지 홍보 합니다 마지막 어린 여자애 신천지 오 세 요 하네요 이런 창칭 애 들 가정 파탄 나고 직장 잃고 학업 포기 전 재산 탕진 교주 이만 희 꾐 빠져 사는게 상당히 안타깝습니다	FALSE
유튜브 신천지 롤리폴리 검색 하시면 나옵니다	FALSE
내 주변 신천지 빠져 전 재산 탕진 생업 다 잃어버리고 가족 들 웬 수지 간 된 사람 들 한 둘 아닙니다 이 새끼 들 진짜 악질 적 성경공부 운운하면서 자기 직업 자기 가족 자기 재산 다 헌납 하도록 유도 합니다 이 새끼 들 진짜 교주 이만 희를 비롯 해 싸 그리 조사해 콩밥 좀 먹여야 합니다	FALSE
신천지 때문 사내마 내하는 집 많음	FALSE
그렇게 이죽거리며 말 하면 기분 좋니 신천지 종교 아니고 개인 신봉 자 들 집합 단체 거든 함부로 연결 짓지마라	FALSE
정신병 자 아닌 이상 멀 정 종교 놔두고 왜 저런 걸 믿겠나 애초 정신병 자 들이기에 믿는건데 근데 너 그런 소리 아무리 해봐야 그냥 내부 권력 싸움 밀려서 폭로 한 걸 안보 인	FALSE
멀쩡한 종교 뭐	TRUE
기독교 대 한 예수교 장로회 다녀요	TRUE
전두환 옳았다 신 천 지애 들 삼청교육대 일주일 보내면 불교 전향 함	FALSE
전국 신천지 집단 폐쇄 해야 합니다 가족 중 빠져있는데 전혀 말 듣지 않습니다 ㅡㅡ	FALSE
소름 돗 네 정말 안타까운 사람 들 주변 봤어요 항복 했던 가정 파탄 것	FALSE
그래서 세뇌 교리 공부 무서운것	FALSE
성인 되어서도 이런 곳 빠져드는 사람 들 도무지 이해 가안 간다 불쌍한 영혼 들	FALSE
그렇게 불륜 불륜 불륜 말 할 때 예수님 마리아 관계 영상 짜 집기 말 나를 귀신 취급 하던 것 들 업 드려 ㅋㅋㅋ	FALSE
일베 포함	FALSE
종종 무신론자 들 기독교 신천지 무교 입장 똑같다고하는데 정신차리세요 기독교 세계 대종교 그 교리 수 천년 이어오며 검증 된 종교 입니다 먹 사나 타락한 애 들 있지만 적어도 교리 자체 문제 없는건데 신천지 교리 이만 희 구원 자 입니다 이 종교 사이비 차이 입니다	FALSE
그러게요 그렇게 따지면 수 천년 서양 정신 물질 문화 전세계 호령 영국 미국 청교도 정신 죄다 기독교 정신 이 걸 신천지 동 급 생각 하는 새끼 들 진심 지능 낮은 새끼 들 거지	FALSE
위 신천지 한 마리 기어 나왔네	FALSE
하나님 돌려 드려야 할 영광 중간 가로 채고 자신 높이는 자 들 다 그 누구 일지 마귀 도적 이 사기꾼 들입니다 과 감히 벗어나시기 바랍니다	FALSE
창조주 하나님 인류 구원 자 이신 예 수 그리스도 대적 하는 교만하고 악한 악마 집단 저 것 들 광명 천사 가장 하여 이만 희 교주 신이라며 신도 들 미혹 하여 영혼 사냥 하고 결국 은 영혼 들 지옥 끌고가는 물귀신 집단 실체 알 악마 그 자체 무서운 집단 이단 사이비 종교	FALSE
문 천지 교 유사종교	FALSE
얼마 전 길 신천지 포교 하는 젊은 아줌마 늙지도 죽지 않는 사람 있다 해 성경 명백히 나와있다고 해 그런데 많이 늙어 보이던데 설명 가능합니까	FALSE
신천지 옷 입고 포교 하는거 보면 정신병 자 같더만 돈 때문 폭로 되는 사이비 집단	FALSE
어휴 이만 희가 하나님 바보 천치 들 어떻게 사람 하나님 믿을수가 있냐 그 사람 병 고치디 귀신 무서워하디 영적 능력 있디 제발 정신 좀 차리고 그 사이비 집단 나와라 이 사회 어지럽히지 말아라	FALSE
결국 은 지 돈 못 챙기니 나와서 폭로 하겠다는건데 까발리는건 좋은데 그게 당 신돈	FALSE
신천지 빠지는 애 들 보면 하나같이 힘들고 어렵게 사는 젊 은애 들 투 성 마른 오징어 오징어 즙 빨 먹는 이마 ㅋㅋ 휴 사기치는 새끼 들 당하는 새끼 들 ㅋㅋ	FALSE
모든 사탄 꾀임 하나님 선함 앞 무너질것울 확신 합니다 주님 하실 일 기대하며 기 도합 니 신천지교 이제 그만 배도 자가 아닌 선한 피조 물 다시 태어나기를 기 도합 니	FALSE
어떻게 이 만 희가 하나님 구원 자 믿고있는 신천지 젊은 남녀 들 보면 정말 안타깝다 근처 신천지교회 있는데 젊은이 들 몰려가는걸 볼때 정말 내 자식 들 같아서 말리고싶다 정말 예전 신천지 빠진 딸 말리는 엄마 보고 아줌마 누구세요 하 는걸 보고 같은 엄마 로써 가슴 너무 아팠다 다른 걸 다 떠나서 이건 아니잖는가	FALSE
하나님 교회 이단 맞아요	FALSE
하나님의교회 제 일 성경 적 데	FALSE
친구 들 중 젤 정상 적 애가 그 교회 다니던디 나쁜 교회 아닌거 같은데	FALSE
월간지 하나님 교회 대해 많이 나오던데요 읽어 보니 정말 하나님 말씀 성 경 중심 하고 신천지 같은 곳 전혀 아니던걸요 다시 제대로 알아보세요	FALSE
직장 동료 였던 애 부모 하나님 교회 다니더라 그것 종교 우리 엄마 교회 다닌다고 겉 아 그렇냐고 거기 사이비 이야기 해봤자 절대 아니라 할거니까 속 좀 비웃었다	FALSE
신천지 사 기 집 당 폭로 드디어 내부 그것 가장 가까이 폭로 되었다는 사실 이제 신천지 사기 집단 나와 가정 자녀 들 온전 하게 되돌아가기를 간절히 바랍니다	FALSE
이제 빠져나와 실체 폭로 한다하니 환영 한다 이 종교사 기 집단 무너진 수많 응 가정 청소년 들 샹각 참회 하는 심정 사실 실체 밝혀야 할것이다	FALSE
진실 알 돼서 〰️ 너무 다행 입니다 〰️ 용기 박수 보냅니다 👏	FALSE
대 깨문 들이 딱 저 모습	FALSE
김남희 님 인해 그것 알고싶다 한번 나왔으면 해 저 도 신천지 인해 가정 깨졌지만 많은 분 들 속 있는게 너무 마음 아 푸네 유 튜버 존존 tv 화이팅	FALSE
신천지 것 들 정신차리자 니 들 옛날 둘 불륜 내 말 할 때 니 들 뭐라 했어 마리아 예수님 관계 다 거짓말 영상 조작 나 욕 하지 않았냐 그럼 지금 거짓말 이나고 말 해보지 ㅋㅋㅋ 이 거 김남희 돈 때문 이러는거 내 봐도 그래 그럼 니 들 생각 걸 해야지 그 돈 이만 희가 준거야 횡령 이런게 아니라 횡령 맞으면 이런 언론플레이 해봐야 뭐 하는데 니 들 참 얼마나 생각 없는 사이비 맹 인지 좀 거울 보자 ㅋㅋㅋ	FALSE
오래전 부터 신천지 사기 종교 집단 것 왜 사람 들 모를까 요 참 어리석은 사람 들 많아요 이번 기회 신천지 실체 만방 확실하게 드러나길 기대합니다	FALSE
종교 란 다 고만고만하다	FALSE
기독 이슬람 한 뿌리 결국 둘다 나약한 인간 만들어 낸 전설 고향	FALSE
삼 인성 호 말 있는데 요즘 세상 호랑이 아니고 메시아 만들어 그래서 종교 장사 시작 하는 거 자기 들 끼리 북 장구 나도 메시아 얼마 둔갑 할수 있어 몇 인간 들 짜고 사실 동 업자 들 허경영 보니 옆 인간 들 허경영 뭐라 하면 무조건 띄우고 찬양 신 그러고 영락 없는 사이비 교주 모습 그대로 그게 영업 수법 짜고치기 고스톱 하여간 메시아 많아 좋은데 사기꾼 왜 이리 많냐 나라 꼴 사기 공화국	FALSE
양심선언 줄 이어가기 바랍니다 지금 어딘가 멀쩡한 사람 들 파멸 시키고 병들게 하려고 안간힘 쓰는 인간 들입니다	FALSE
자위 매국 당 신천지 한 몸 새누리 신천지 이만 희가 새누리 이름 자기 지어 줬다고 자랑 함 ㅋㅋ	FALSE
종교 없어져도 전쟁 살인 반 줄어 듭 다	FALSE
어떻게 인간 하나님 믿는 바보 들 있지 눈 삐었 자기 자신 못 믿으니 저런 한심한 넘을 하나님 믿는거야 신천지 정신병 자 사 회부 적응 자 들 믿는거다 정신차려라	FALSE
신천지 공산당 세상 없어져 야할 ㅆㄹㄱ	FALSE
성경 제대로 알 왜 신천지 사이비 적 그리스도 분간 할수 있다 진리 말씀 성경 제대로 읽어 나가길 바 본다	FALSE
악마 집단 순진한 사람 들 돈 유혹 해 절대 못 빠져나오게 얽어 매기 함 사람 등급 A B C D 등 등급 매겨 포교 활동 함 한번 빠지몃 절대 못 나옴 나올시는 다 벗긴 후 내 보냄	FALSE
드디어 실체 밝혀지는구나 역시 ㅋㅋㅋㅋㅋ	FALSE
사회 망 뜨 리 기생충 같은 신천지 이번 제대로 까발려라 재산 해도 수 천억 데 아직도 분별 하지 못 있는 신도 들 빨리 나오세요	FALSE
무신론 이단 빠지지 않는 유일한 길이 무신론자 들 행복할지어다	FALSE
이만 희가 하나님 이런 종교 빠진 사람 들 도대체 무슨 생각 사는 건지 이해 불가 차라리 허경영 믿어라	FALSE
우리 사촌누나 이만 희 보고 대통령 님 이란다 세뇌 이렇게 무서운거야 진짜 역겹	FALSE
사이비 이단 판치는 조선 사기 민족 극혐	FALSE
쪽발이 왜 나서	FALSE
미치지 않고 서야 어떻게 이런 데 비교 할까 정신차리세요 세상 똑바로 보세요	FALSE
남 보면 똑같아 보여요 미치지 않고 그러는게 더 무서운 겁니다	FALSE
정신차리고 신천지 나오세요	FALSE
신천지 요새 지하철 입구 당당히 전단지 돌리고 네이버 메인 버젓이 선행 기사 랍시고 올리며 포교 활동 하던데 뭔가 정부 쪽 믿는 뒷 배 있냐 사이비 종교 갑자기 왜 양지 나와서 설치는데	FALSE
지난달 전철역 포교 하던 예쁘장한 대들 ㅡ 이만 희 교주 님 안 죽는다고 성경 그리 나와 있다고 하더 이 다그 교주 님 넘어선지 꽤 됐는데	FALSE
앗 싸 제대로 드러나라 그래도 이만 희가 맞다고 따라갈 사람 또 따라 가겠지 아이구 ᆢ 속 터져 속 거 확실하게 다 들통 나기 둘러대지 못 할께 터져 가지 거기 있는 사람 들 거짓 속 눈 벗겨지 기를 바람	FALSE
저런데는 신도 들 사회 요 소 요소 다 포진 되어 있고 영향력 또한 무시 못 한다 그래서 쉽게 없애지 못 한다 통일교 마찬가지	FALSE
광화문 이단 신천지 반기독교 선동 하는 곳 이단 신천지 빠져 집 나간 자식 둔 부모님 하소연 하더라 신천지 들어갔다 나온 사람 들 하나같이 가족 말리 가족 사이 이 간질 시켜서 애 들 가출 시키고 부부 이혼 한다고 합니다 어리석게 가족 말 안 듣고 이단 신천지 말 믿을수가 있을까 도저히 이해 안가지만 멍청한 사람 들 꾀는 이단 신천지 자체 박멸 시켜야 합니다	FALSE
그걸 겪어 봐야 아냐 ㅋㅋㅋㅋㅋ	FALSE
애초 태생 자체 사기 태어났어요 이만 희는 지가 죽지 않는 보혜사 예수님 동격 썰을 풀 젊은이 들 홀려 돈 뜯더니 결국 세 컨드 한 데 당하네요 저 사이비 종교 돈 받친 정신 나간 사람 들 많아요 가정 풍지 박살 사람 엄청 많아요 이만 희는 종교 빙자 사기꾼 악 입니다 신천지 없어져야되 요	FALSE
구원 자 아닌 건 다 알 않나 신자 들 이해 안 돼	FALSE
사이비 한번 빠진 사람 들 폭로 해도 믿지 않을거 같아요 맹신 무서운 이유 입니다	FALSE
결국 진실 드러나는구나	TRUE
누가 봐도 사이비 이단 왜 저기 빠지는지 모르겠다	FALSE
신천지 교회 입구 예 써있어요 신천지 믿지 마세요 이나라 예 이 단 종교 너무 많음 하나님의교회 이단 통일교 이단	FALSE
신천지 문 천지 교 그 교주 그 광신도 들	FALSE
새누리 애 들거	FALSE
언 제적 새누리 ㅋ 자 한당 민주당 쓰레기 들	FALSE
신천지 똑 같은 집단 또 하나 있는데 말 안해 다 알지요	FALSE
신천지 또 라이 요즘 기독교 보면 사이비 따로 있는 건가 싶음 그냥 신 또는 누군가 믿어야만 하는 종교 전부 정신병 보는게 맞는 듯	FALSE
신천지 탈퇴 자 들 양심선언 환영 합니다	FALSE
탈퇴 자 아니라 잘못 해놓고 반성 하지 않아서 쫒 겨 겁니다	FALSE
bbiz 애쓴다 ㅋㅋㅋㅋ 이 단 주제 ㅋㅋ	FALSE
신천지 온 얼마 안되 요 보니이단 아니네요 말씀 너무 좋아요 성경 속 시원하게 풀어 줍니다 성경 속 인생 답 명확하게 들어 있다는것을 깨 달았습니다	FALSE
신천지 사람 들 모름 이단	FALSE
이제 정신차렸으니 다행 아직도 신천지 빠진 사람 들 하루빨리 정신차리길 바랍니다	FALSE
사기 집단 신천지 이 사기 집단 들 매장 시켜라	FALSE
원래 사이비종교 집단 몰랐나 ㅋㅋ 신천지 이름 사기 삘 나지 않나 ㅋㅋ	FALSE
신천지 잘 나가니 달천 교도 천하 잡아 이제 그 들 토벌 할 때 세네 이제 동방불패 임청하 다시 평정해야겠다 이 어지러운 난국	FALSE
독립선언서 그래 적 있지 누가 약칭 쓰냐	FALSE
신천지 빠는거 봐라 ㅋㅋ	FALSE
구원 자 동거 합 비정상 적 그 들 옹호 하는 신천지 빠진 사람 들 정신 차리세요 이단 들 교주 특색 성적 문란 가장 순위 입니다 돈 여자 ㅠㅠ	FALSE
이만 희의 동거 녀 김남희 씨 용기있는 진실 고백 박수 보냅니다 이제 이만 희의 실체 알 되어 천만 다행 입니다 신천지 성도 더 이상 이만 희의 수렁 늪속 빠져들지 집단 나오세요 이만 희에게 속지 마세요	FALSE
한국 기독교 문제 하나님 예수님 안 믿고 목사 믿음 그러니 신천지 같은 가정 파괴 시키는 사이비 나옴	FALSE
그걸 왜 지금 알았냐고 다른 사림 들 이미 사이비 다 알 있었는데 말 이징	FALSE
내 눈 같은 사기꾼 끼리 싸움 보인다	FALSE
하나님 혼꾸녕 내주세요	FALSE
저런데 빠지는게 난 더 이해 가안 간다 종교 란걸 가져 본 적도 없는 사람 차라리 성서 아주 많이 공부 이는 빠질수가 없는데 울 동네 쟈들 대들 상주 시키면서 꼬 시드라 니 들 그냥 사이비 였어	FALSE
수고 많아요	TRUE
우리나라 민 ㅈ 당 대 깨문 달창 들 신천지 다를 바 무엇	FALSE
대 깨문이 쫌더심함	FALSE
신천지 대순진리회 통일교 몰몬교 여호와 증인 남 묘호 개교 사이비종교 대 부들 공통점 가정 파탄 정상 적 사회생활 불가 전 재산 탕진	FALSE
신천지 뿐이겠나 개신교 천주교 불교 모든 종교 진리 돈 믿지 돈 안 내 봐라 어느 종교 좋다고 보듬어주나	FALSE
신천지 이단	FALSE
개 희는 그냥 신도 들 돈 뜯어 먹는 마귀 사탄 적그리스도 임 ㅋㅋㅋㅋㅋㅋㅋㅋㅋㅋ	FALSE
신천지 사시 분이죠	FALSE
신천지 바로 이단 사이비 이만 희는 앙 어떻게 이렇게 많은 청년 들 자기 똑같이 이단 사이비 만드 응징 해라 신천지 없어져 야할 집단 ㅠ	FALSE
제발 사람 구원 자라 믿지마라 이만 희는 사람 죽는다 그냥 늙은 사기꾼 일 뿐	FALSE
■ 악성 신천지 건강한 교회 총회 욕 하며 젊은 청년 들 현혹 쇠뇌 시켜 세 넓혀 가고 있다 국가 적 암 덩어리 집단 빨리 메스 도려내고 국가 적 수술 필요하다	FALSE
제발 무너 뜨 려 지지 다	FALSE
이미 전 국민 다 알고있어요 빠르면 ㅉㅉㅉ 양심선언 하신 용기 박수 보냅니다 이제 제대로 신앙 생활 하시길 사람 우선 되고 우상 되는 종교 있을수 없습니다	FALSE
사기꾼 들 본인 들 알	FALSE
양심선언 응원 합니다	TRUE
둘다 재산 국고 몰수 사기죄 구속 해야 함	FALSE
신천지 저기 다니는 사람 들 진짜 하나같이 ㅆㄹㄱ 들밖에 없더라 집단	FALSE
지방 이름 못 들어 본 신문 신천지 관련 기사 뜨면 떼거지 달려와서 댓글 달 많이 본 기사 랭킹 올리던데 여긴 그래도 정상인 들 많네요 사이비 종교 빠졌다는거 인정 하기 싫겠지만 그게 현실 입니다	FALSE
같이 해처 먹다가 뭔 수가 틀어졌냐 요즘 기독교도 비슷해	FALSE
신천지 패악 드러나고 거기 빠진 자 들 해방 되 기를	FALSE
이제 신천지 빠진 젊은 청년 들 가정 돌아오기를 소망 합니다 몸 마음 가정 다 파괴 되는 신천지 반드시 없어져야 합니다	FALSE
이만 희가 하나님 뭐 그냥 또 이 집단 이지 이런 황당한 걸 절실 히 믿는 사람 들 많다는거에 경악 ㅠㅠ 죄다 어디가 둬 두 태워 버려야 되는데	FALSE
JMS 도 사라져 야함	FALSE
우리 국민 들 그래요 어디 맛집 방송 나오면 줄 서 가면 맛있다고 먹어요 설령 맛 없더라도 줄 쓰고하는 분위기 방송 왔으니 맛 있는거겠지하며 맛없다고 말 못 쳐 먹으요 이렇게 세뇌 되요	FALSE
세뇌 단단히 되어있는 집단 신천지 한번 빠지면 거기 하는말은 무조건 옳다고 믿고 신천지 대한 비난 나오면 필사 적 방어 하려 합니다 무엇 진짜 를 생각 하지를 않습니다 또한 신천지 성도 들 신천지 의심 가지 어떻 게 신천지 옳다고 세뇌 하는 집단 입니다 교회 그만둔다고 하면 밤 가 넘어서도 대화 풀 자고 하 집 찾아오고 심지어 연락 안되면 집앞 대기 하고있다가 붙잡고 자기 들 주장 참된것이라고 계속 회유 하려고 난리 칩니다 일방 적 자기 주장 계속 하고 그러니 벽 이야기 하는 느낌 입니다	FALSE
요새 버스광고 판 신천지 광고 그러던데 미친거 아닌가	FALSE
신천지 얘 들 말 하는거 믿는게 너무 웃김 사촌 여동생 배웠다는 약사 여기 미쳐서 가정 깨지고 ㅡㅠ 이제 실체 좀 알아라	FALSE
재산권 다툼 들어가야 정신 차리는구나	FALSE
무서운건 이런 양심선언 자 나 거기 신도 들 안 믿는다는것 거기 선 벌써 김남희 예수 배신자 그럴 싸하게 포장 해서 교육 시키고 있을껄또 성경 어는 구절 빗대서 가르 키 겠죠 제발 많은 주 부들 젊은 청년 들 깨단 길	FALSE
맹신 나 판단력 남 맡기는 자기 주도 권 상실 모두 제 정신 차리고 삽시다	FALSE
성경공부 시 켜준다는 말 현혹 당해 쫏 갔다가는 사 기 집단 빠져나오지못하게 됩니다	FALSE
저 여자 속셈 뻔하네 의기 행동 아닌듯 개인 원 한 풀이 겠지	FALSE
대한민국 개신교 떳떳한가 하나님 예수님 말씀 거역 종교 이단 아닌가	FALSE
돈 안되니 바로 배신 ㅋㅋ	FALSE
니 몰랏겠 다 알 있던건데 이 죄 어찌 할꺼니	FALSE
피 하는게 답 세뇌 돼서 돌은것 들은 본인 돌은줄 모른다 정신병	FALSE
아쥬 그냥 무대 기 더 이상 거짓말 못 하게 다 들통 버려랏 다시는 포교 활동 못 하게 여기저기 안 퍼진데 없이 일 하지 이번 기회 신천지 거짓 싹 다 잡히길 얏호	FALSE
저걸 믿는 사람 들 신기하다 ㅋㅋㅋㅋㅋㅋㅋㅋㅋㅋ	FALSE
민주 노총 vs 신천지 vs 공산당 vs IS 이슬람 이중 어느 조직 제 일 못 된 집단 이오 추천 답 달아주시오	FALSE
거기 자 한당 넣어주시요 맨 마지막	FALSE
문재인 vs 신천지 솔직히 둘 중 어떤 넘이 더 사기꾼 더 나쁜 넘 문재인 라면 공감 신천지 라면 비 공감	FALSE
nusa 경상도 사람 내 모든 걸 올인 쫄리	FALSE
할 일 없음 잠 쳐자빠 차라	FALSE
신천지교 정리 다음 문 천지 교도 들 정리 하자 와	FALSE
사이비 이단 왜 유독 기독교 많은 건가 불교 천주교 조용한데 이 놈 기독교 조용할 날 없다 종교 관련 사건 사고 터지면 열 여덟 꼭 기독교 더	FALSE
문 천지 교 얘 긴 줄 ㅋㅋ	FALSE
신천지 누가 봐도 이단	FALSE
이쯤 되면 지 파장 들 양심선언 할 때 되었는데 양심선언 미리 하지 혹시 법접 들어가면 정상 참작 되는데 박 그네 하수 처럼 되지 너거 지 파장 들 다 알 있잖아 ㅎ 거짓 나가면 할거 없으니 거기 남아있는거 다 아는데 하나님 회개 진정한 신앙 되는게 어떠세요	FALSE
대낮 광주 도로 가에서 벌어졌던 납치사건 알 보니 신천지 빠져 집 나간 대학생 딸 가족 들 납치 한 것 정신 적 치료 필요할 정도 사이비종교 위험 상상 초월 한다	FALSE
신천지 반드시 이 땅 없어져야 할 종교사 기 집단 입니다 맞는 말 입니다	FALSE
문재인 하겟 대 깨문 들	FALSE
이만 희나 빨아라 쓰레기	FALSE
신천지 뿐 아니다 우리나라 순 복음 명성 소망 등 교회 모두 사기 꾸운 친목 집단 예수 빙자 사	FALSE
신천지 다니는 지인 신천지 이만 희가 돌아가시면 끝 아닙니까 물어보니 대학교수 지내신 그 분 말씀 이 희 교주 죽지 않고 영생 한답니다 제 기 막혀서 더 이상 말 못 했습니다 요즘 세상 교수 지내신 분 그렇게 믿고있다니	FALSE
다른 종교 전부 사긴데 멀 그리 흥분하냐 믿고말고는 다 자기 몫	FALSE
인자 잘 처 먹고 즐기다가 ㅋㅋㅋㅋ	FALSE
jms 신천지 통일교 본인 들 이단 모른다 진심 불쌍타 인생 들 허비하고	FALSE
종교 인간 나약함에서 온다 스스로 성찰 건강한 삶 유지 하도록 노력 하는 것 종교 을 대신 할수있다고 생각 한다	FALSE
신천지 천하 사기 이단 탈당 하기도 힝 곳 폭력 쓴다	FALSE
이교회 저 교회 다녀 보아 말씀 없고 신앙 세상 모임 별 차이 없어서 신천지 온 사람 입니다 폭력 절대 없습니다 말씀 없는 한기총 말씀 넘쳐나는 신천지 시기 질투 해서 정치권 손잡고 그 들 세력 힘 이단 프레임 씌우고 온갖 거짓말 퍼뜨리 있는 겁니다 속지 마시고 시 온센 타 직접 말씀 들어 보시 판단 해 보시길 바랍니다	FALSE
이나라 없어져 야할 종교 신천지 뿐 종교 더 이상 순수한 종교 영역 잃어버린지 오래 다 기독 교만해도 종교 아니고 정치 개입 하며 선동 앞장서고 온갖 비리 불법 있어도 처벌 받기 힘든 세상 않냐 심천 비판 받을 이유 없지	FALSE
대체 신천지 어느 별천지 온거 임 왜 믿는거 임 믿으면 나 뭐 떨어지는거 임 노 이해	FALSE
개독교 단어 만든 집단 신천지 좋은 말로 구슬려서 사람 들 끌어 드리는것도 한계 왔는 갑다	FALSE
신천지 믿던 순 시리 그네 한나라당 당 명 새누리 바꾸라고 한 거 같다 신천지 새누리 지 맘대로 되는거 보고 순 시리 지었을 흡족한 미소 떠올리면 소름 돋음	FALSE
성경 보면 분명 뻔한데 사람 구원 자 믿는 멍청한 사람 들 마귀 붙잡혔어도 단단히 붙잡혔지 성경 가르치는것도 완전 이상한데 어떻게 빠질수가 참 빠진 사람 들 불쌍하지만 빠지는것도 기적 요 저런 자기 구원 자 하는 사람 아마 금전 유혹 되어 마귀 도구로 사용 되었어	FALSE
이만 희를 신 믿고 빠지는 인간 멍청한거지 ㅎㅎ	FALSE
성경 대해 모른다 할지라도 예수님 낮은 곳 섬기고 자신 드렸습니다 이 땅 인간 자신 개인 이름 영광 받는 집단 명백히 이단 사이비 입니다 간단한 진리 입니다 특별히 청년 들 많이 전도 했다는 김남희 씨 이렇게 용기 내셨으니 공개 적 사과 하시고지 금도 속 있는 젊은이 들 돌아서는데 용기 낼수있게 도와주시기 바랍니다	FALSE
말씀 하나님 데 말씀 없는 목사 님 들 신천지 이단 거짓말 속지 마세요 성경 사람 하나님 형상 지으셨고 누가복음 장 절 말씀 은씨 하셨으니 말씀 받은자는 하나님 씨 받았으니 하나님 아들 신 의아 들 되는 겁니다 요한복음 장 절 성 경 은폐 하 못 하나 하나님 말씀 받은 사람 들 신 하셨거늘 신천지 말씀 전하 기 위해 시온 선교 센 타 운영 하 값 없이주라는 말씀 행 하 이유 알겠지요 성경 나타난 계시록 장 새 하늘 새 땅 의 약자 신천지 입니다	FALSE
김남희 석 고 대죄 해 신천지 왕비 노릇 하 너 또한 수많은 사람 들 악하고 거짓 된 길 나서서 미혹 했다고 신천지 명이나 눈 멀고 병들고 그 가족 들 가슴 피멍 들 한 이만 희와 김남희	FALSE
신천지 왜 이렇게 거짓말 잘 해요 신천지 다닌다고 당당하게 말 하는 사람 못 봤고 너 신천지 물으면 절대 아니라 함 이만 희가 시킵니까 거짓말 하라 제발 거짓말 좀 그만해요	FALSE
맞아요 성경제 리 켜주는 곳 신천지 입니다 기존 교인 들 신 천지인 들 성 경 박사 말 하더군요	FALSE
진리 말씀 해주시네요 성경공부 하면 신 친지 맞아요 기 성교회 공부 아예 안 하죠 ㅎㅎㅎ	TRUE
신천지 여론조작 팀 대응 늦네 ㅋㅋㅋㅋㅋ 분명 자기 이야기 들 뜨면 나쁜 이야기 들 쏙 내려 버리던데 ㅋㅋㅋㅋ	FALSE
청평 제발 나가라	FALSE
결국 돈 때문 서로 난리치는거 자 ㅋㅋ	FALSE
사이비 광신자 집단 ㅉㅉ 참 구걸 해서 벌어 먹고사는 방법 가지가지 진짜 사기 능력 어떻게 저렇게나 광신 교 신자 들 바글 거리 정말 충격	FALSE
신천지 통일교 여호와 증인 노답 신천지 여대생 들 미처 있더만 아비 애 미도 몰라 본다 통일교 뉴스 보 쌍 결혼 시키고 ㅋㅋㅋ 여호와 증인 거리 책 놓고 뒤 지켜 보는데 무섭다	FALSE
신천지 도대체 뭔 지 몰겟 네 함 검색 해봐야겟어여 ㅈ 여호와 증인 같은건 가요 제발 배우자 이런 정교 가진 사람 안 낫음 좋겟 네 용 ㅜㅜ	FALSE
신천지 때문 멀쩡한 자녀 들 잘 못 되고 가정 파탄 난다 없어져 야할 악의 무리	FALSE
신천지 우리나라 뿐 아니라 세계 적 癌 적 존재 사이비 종교 중국 신천지 가정 파탄 원인 인하여 기독교 선교사 조차 추방 당하고 가정 교회 들 해체 붕괴 되었다	FALSE
그래 봤자 본인 사이비 이용 해서 잘 먹고 잘살려다가 교주 팽 당하니 폭로 하는 것일 뿐 ㅋㅋ	FALSE
오직 예수 그리스도 길 진리 생명 이십 니 예수님 통해 회개 모두 구원 받게 되시길 기도 드리겠습니다	TRUE
당연한거아니냐	FALSE
신천지 사회 악	FALSE
세기 이만 희 같이 더러운 놈 교주 떠받 드는 또 라이 들	FALSE
어떻게 이런 종교 단체 빠지나 진짜 모르겠네 이해 못 할 인간 세상	FALSE
똑같은 여자 어차피 사기 쳐서 번 수백 억 대한 소송 권 저 여자 왜 있는거냐 사기 친 돈 소송 걸어 놓고 사 기 종교 비난 하는게 말 됨 신천지 법적 책임 질 때 저 여자도 같이 져야 됨	FALSE
사람 구원 자 될수 없습니다 지금 신천지 계사 분들 제발 정신차리시고 가정 돌아가시고 새로운 신앙 생활 하세요	FALSE
그 걸이 제아	FALSE
돌아오라 내딸 제발	TRUE
우리 동 내 포교 활동 하지마라 땅값 떨어진다 어디 살기 좋은 강남 권 더럽히냐 미천한것 들이	FALSE
참 세기 저런 사이비종교 속 는 사람 들 있다는게 졸 신기 😅😅😅😅😅😅	FALSE
상식 적 저 정상 길 바닥 도를 아시냐 영업 뛰는 것 들 다른 뭔 데	FALSE
신 천지인 들 성경 단어 그대로 해석 하지 히브리어 모름 영어 된 번역 알려줘도 못 알아듣고 자기 것 우김	FALSE
뭘 자기 믿었고 속 았 어 웃기 있어 그냥 공범 잔데 돈 문제 이해 관계 틀어지니 공격 하는 거지 저 여자도 똑같이 악질 거야	FALSE
때 어느 땐데 단 빠지냐	FALSE
저런 종교 집단 특별법 만들어서 강력 처벌 해야 되는거 아닌가 ㅡㅡ	FALSE
신천지 기독 연합 내 눈 다 전광훈 같 소만	FALSE
지금 당장 폭로 하지 않고 다음주 하겠다는 이유 무엇 일까 요 네 고 중	FALSE
누구 신의 대언 자 될수 없다 사기꾼 속지 마세요	FALSE
역시 신천지 사이비 이단	FALSE
구원파 추가	FALSE
정말 개판 오 분전 악다구니 더러 븐 하차 장 수준 추락 하는구나 인자 그 종교 실체 폭로 하는 것 자체 이미 폭 망할 단계 왔 음 증명 해 주는 거 좌우간 앞 볼 하겠다 종교 허울 둘러싼 이전 투구 난장판 실체	FALSE
속기 같이 다른 사람 들 등 쳐 먹었으면서	FALSE
백 억 대 소송 무슨 황당한말이야 결국 종교 빌 미로 아둔한 사람 들 상대로 금전 갈취 한거아냐 그걸 달라 소송 하는건 또 무슨 시츄에이션 이제 신천지 이단 마귀 집단 임 알 빨리 나오는게 최선 입니다 사기꾼 말 현혹 되어 돈 버리고 몸 버리지 마시고 답답한 인생 들이네요 ㅠ	FALSE
■ 사회 초년 생 들 꾀어 사 기 집단 성장한 신천지 국가 적 암 덩어리 집단 국가 강력하게 단속 해체 안 하면 수 많은 젊은이 들 인생 계속 말살 하게 될것이다	FALSE
Jms 빠진 사람 좀 구 해줘요 우리나라 사이비종교 숙주 나라 아	FALSE
앞날 창창한 대학생 들 미래 망치는 이 단 집단 입니다 신천지 매우 교묘하고 아주 계획 적 속 접근 함 절대 속지 마세요	FALSE
이만 희가 하나님 미쳤구만 똘 아이 들	FALSE
용기 있는 결단 응원 합니다	TRUE
구원 자 동거 녀 구원 자랑 돈 가지 싸우네 ㅋㅋ 결국 돈 구원 자 였네	FALSE
제발 과천 꺼져	FALSE
기자 보도 자 어법 좀 바르게 씁시다 세간 관심 모아지고 있다가 뭐임 세간 관심 모이 있다 또는 세간 관심 끌 있다가 바른 표현 모으다는 타동사 모이다는 자동사 그런데 모아지다는 영어 타동사 수동태 만들어 자동사 처럼 쓴 표현 한 마디 변태 어법 이 랄 수 있다 모 이 다라 자동사 있건만 변태 어법 왜 쓰 남 시사 방송 출연 진 들 자주 보여진다라고 객관 적 척 자기 주관 표현 하는 방식 비겁한 변태 로 보입니다 또는 자신 있게 저 봅니다 가 옳은 표현	FALSE
정말 개토 레이 들 정말 많다 저런 것 들 재물 육신 바치는 사람 들 뇌구조 어떨까	FALSE
이런 걸 믿고 돈 다 갖다 준 사람 들 바보	FALSE
지금 착각 속 빠져 신천지 푸욱 빠져 헤메 사람 많으니 꼭 폭로 해야 된다고 봅니다	FALSE
신천지 없어져 야할 이단	FALSE
딱 봐도 사이비 ㅡㅡ 어떤 종교 가족 버리라고 하냐 그게 니 들 하나님 원하는거라 믿는것이 사기 ㅡㅉㅉㅉ	FALSE
사람 사람 어찌 구 원하랴 속 는게 더 이상하다	FALSE
신천지 실체 ㅠ 밝혀져야죠 ㅠㅠ 진실 밝혀지겠죠 응원 합니다	TRUE
우리 종종 인내심 잃는다 나도 그렇다고 교황 말 하지 않았나 인간 믿을 수가 없는 존재 자기 자신 믿기 힘들 때 있지 않나 그런데 어떻게 인간 신 믿는가 인간 신격화 하는 종교 정치 집단 다 사기 보면 된다	FALSE
아니 나이 먹고 저런데 빠진 이유 모르겠음 ㆍㆍ 신앙 것 나와 일대일 아닌가 ㆍㆍ 사람 왜 믿냐 ㆍㆍ 내 마음속 하나님 믿을것이지 ㆍㆍ 홀린 사람 노예 되지말어라 ㆍ	FALSE
종교 자체 다 신도 들 쩐 갈취 해서 몇몇 호의호식 하는것이다 이단 삼 단 다지 들 끼리 논리 거기 빠진 소위 신도 들 어리석은 것	FALSE
부모 못 알아보고 헛된 욕망 사로잡혀서 탐욕하는걸 신앙 믿음 글자 포장 해괴 집단	FALSE
존 윅 보내고 싶다	FALSE
ㅋㅋㅋ 진짜 저 많은 사람 들 지구 나이 살이란다 사기 집단 똑같은 공범 들 맞다	FALSE
신천지 하나님의교회 없어 저 야할 집단	FALSE
전광훈 내부고발자 나와야	FALSE
내 눈 신천지 기독교 별다름 없다 누가 누구 보고 이단 하는지 그 이단 뜻 정확히 뭔 지	FALSE
내 조카 신천지 빠져 광신도 적 행보 하고 있지만 정작 본인 제 삿 상 절하 술 먹고 담배 피 돈 되는 일이 라면 물불 안 가리고 다한 다 신천지 다니면서 세상 사람 들 다를 바 없는 행동 들 왜 하냐 고 물었더니 삼촌 돈 벌기에는 신천지 만 곳 없어요 신천지 관련 온갖 유령 단체 많이 생겨났고 이를 통해 내 재능 십 분발 휘해 능력 껏 돈 벌 수 있기에 신천지 세상 어떤 기업 단체 좋아요 이만 희가 대 언 자라 주 장함 그 뜻 동조 비위 맞추면서 얼마 돈 벌 수 있으니 좋지요 할 말 잃었다	FALSE
CBS 자체 거짓 방송 게독교 돈 운영 하는 게독 방송 믿냐 국민일보 ㆍ CBS 다 게독교 방송 신문 들 다른 방송사 이런 뉴스 안나	FALSE
나도 신천지 사이비 같은데 기자 이름 오 요셉 ㅋㅋㅋㅋ 개독 사이비 같아서 똥뭍 개 끼리 싸우는거 같아 ㅋㅋㅋ	FALSE
개독 건 팩트	FALSE
당한 자 들 자기 책임 교 주먹 사와 그 밑 광신도 집단 들 말 늘 저렇게 끝 나지 시간 지나면 서서히 실체 드러나게 되는 법 또 하나 광신도 무리 들 한기총 빤 쓰 먹사 전 똘추 그 밑 아멘 팔이 들 박사모 태극기 부대 틀 딱 들의 끝 어떨지 지켜봅시다	FALSE
문슬람 vs 신천지 팝콘 각 누가 먼저 시작 할래	FALSE
이만 희의 여자 어찌 보면 인자 임 침실 얼마나 녹였으면 백 억대 주었을까 ㅋㅋㅋ	FALSE
이 땅 없어져야 할것 들 신천지 문죄인 조국 림종석 대 깨문 들	FALSE
문재인 믿는 대 깨 문 패거리 들 정신병 자 입니다	FALSE
신천지 하나님 교회 이 땅 꼭 사라져 야하는 이단 단체 이건 절대 종교 고도 할수 없는 곳 입니다	FALSE
신천지 문재인 정부	FALSE
제 정신 이 다 알	FALSE
그 쪽 수료 자 들 많던데 이 상태 다 밝혀지 도록 사이비 실체 알려지게 해야 되죠	FALSE
신천지 탈퇴 하면 영 죽는다고 생각 다 더 한심한 사람 들 탈퇴 개신교 돌아오면 영 이 살이 제발 정신차리시길 예수님 사랑 신천지 비교 해봐도 답 오는데 왜 정신 못 차리고 안 나오는지 참	FALSE
신변 조심하세요 ㅠㅠㅠㅠ 신천지 로부터 혹시 해 코지 당하지 마시고 ㅠㅠ	TRUE
신천지 항상 때 니 서로 감시 하는 느낌 그냥 불쌍해 보이더라	FALSE
난 개인 적 신천지 추수 꾼 들이 엄 장로교 성결교 감리교회 잠입 해서 추수 하지 안식일교 안증회 같은데 가서 추수 했으면 좋겠다 그거 이이 제이 ㅋㅋ	FALSE
신천지 망해라	FALSE
신천지 당연히 사이비 김남희 또 다른 종교 집단 만들려는건 아닌가 걱정 되네요	FALSE
저 영감 딱 봐도 사이비 교주 스타일 참 어이없다 성경 한번 봐도 안다 예수님 이미 오셨고 다시 오시 결국 이 세상 심판 자로 오시 이만 희처럼 오지 않는다고 성경 써 있지	FALSE
교주 매 일밤 여자 바뀌겠지 부럽다	FALSE
저기 세 뇌교육 단계 개월 기간 있어 봤는데 사람 약 한 부분 끄 집어내서 교묘하게 자기 교리 것 연관 시켜 빠지게 만듬 ㅡ 정신차려 나와 야할 곳 입니다 ㅡ	FALSE
종교 빙자 한 사 기 집단 신천지 속지 말 자 세상 추방 하자	FALSE
참나 무슨 인간 신 신천지 종교 믿는 사람 들 참 불쌍하고 한심함	FALSE
살아있는 사람 신격화 우상숭배 하는건 북한 같은데서 나 하는 짓	FALSE
오직 예수 그리스도 입니다 십자가 뿐 입니다 기도 하겠습니다	FALSE
신천지 포교 하는 사람 들 너무 불쌍했음 ㅋㅋㅋㅋ	FALSE
이만 희 곧 똥 싸고 죽는다에 한 표 하나님 죽냐 신천지 교도 들 생각 해봐 이만 희가 머 하는지 똑같은 사람 정신차려라	FALSE
무식한 것 들 진짜 지식 없어 백성 망하네 알 말 해라 직접 가서 당신 눈 봐라 바보 들 거짓 방송 맡기지	FALSE
신지 하나 납셨네 ㅋ 으 휴 정신차려	FALSE
신천지 뿐 아니라 대한민국 개신교 대부분 그렇지 전광훈 이 개신교 목 사란다	FALSE
이만 희 없어지면 또 누군가 나와서 또 그거 믿고 안상홍 없어지니 그 둘째 마눌 나와서 믿는 하나님 교회	FALSE
인간 신 믿는것부터가 이미 정상 아님	FALSE
신 믿지도 않지만 기독교도 썩 깨끗하다고 보기 그렇네요 신 목사 더 믿고 목사 교회 옮기면 우르르 따라가는 모양새 보면 시 이비 크게 다를것도 없음 썪 종교 어떤 교리 다 사이비 그 이상 그이 하도 아님 기독교 불교 천주교 해서 예외 아니라고 봄	FALSE
신천지 설교 교리 여기저기 많이 베 껴다가 자기 꺼 인양 했드마	FALSE
이제 알았으니 다행 종교 아닌 사이비 속으 안됩니다	FALSE
모나미 패션 하고 멋 모르고 쫓아 다니는 선량한 사람 들 하루빨리 수렁 빠져나오기 바랍니다	FALSE
다 아는데	TRUE
문제 인씨 신천지 사기치는 법 배웠나 근데 너 똑같이 망해가네 더럽게	FALSE
저기 빠진 사람 들 이해 할수 없음	FALSE
이만 희가 하나님 데 개 사이비 집단 분명한데 참 미련 한 것 들 거기 속 서 ㅉㅉ	FALSE
경험 자 로서 신천 사 기 집단 입니다	FALSE
결국 지 들 끼리 돈 때문 분열 하는 꼴	FALSE
신천지 이제 나가리	FALSE
기자 님 이름 보 교회 니 시나 보넹	FALSE
저 사람 신천지 탈퇴 한지 좀 된 걸 아는데 이단 전문가 들 신천지 측 법적 다툼 중인 김남희 씨 소송 주도 권 가져오기 위해 폭로 나선 것 분석 있습니다 결국 이건	FALSE
기독교인 들 이 세상 사탄 지배 하는 세상 보고 기독교 안 믿는 사람 들 이방인 사탄 자식 보고 상대 하지 말라하지 사실 기독교 사탄 후계 자 들 사탄 뜻 따르고 있다는걸 모르지 겉 선한 척 속 온갖 이 기적 탐욕 적 하느님 얼마나 이 기적 나 믿으면 내 지네 들 원하는거 다 들어줄께 그러니 내 원하는 계명 들 다 지켜라 ㅎㅎ 이렇게 이 기적 생각 어디 있겠냐 그러니 기독교인 들 욕심 많고 이 기적 일수 없다 하느님 자체 사탄 오로지 자기 아는	FALSE
이 기적 생각 배우는데 ㅎㅎ 기독교인 들 하느님 선 선 배우고 선 행 하며 산다 생각 있지만 실상 사탄 배욱 악 배우고 지독히 이 기적 배우고 자기 그러고 산다 는걸 깨닫지 못 살 불쌍한 자 들 평생 그렇게 속 살아라	FALSE
전광훈 평가 좀 해보시요	FALSE
rlf 전광훈 뭐 평가 할 일 있나요 당연히 사기꾼 종교 이용 해 지 정치 해보겠다는	FALSE
신천지 탈출 지능 순	FALSE
이제 알았으니 다행 ㅎㅎ	TRUE
신천지 드디어 심판 받네	FALSE
그걸 이제야 알 됐다니 다행 요 신천지 거짓 교회 입니다	FALSE
성경 이런 내용 있네요 이제 내 너희 말 하노니 이 사람 들 상관 버려 두라 이 사상 이 소행 사람 로서 났으면 무너질 것 이 만일 하나님 로서 났으면 너희 저희 무너뜨릴 수 없겠고 도리어 하나님 대적 하는 자가 될까 하노 하니 사도행전	FALSE
속 서 신천지 빠졌으면서 또 속 전도 하는 집단 속이는거 아니면 답 없는 집단	FALSE
응원 합니다 낱낱 히 밝혀주세요	TRUE
초인종 울리며 근 처사 애 엄마 말 좀전하려고 한다고 해서 문 열 못 닫게 발 밀어 넣고 신천지 종교 영업 ㅡㅡ 종교 사기꾼 들	FALSE
드디어 실체 드러나는군 아내 부공 익자로 보호 받아야 됩니다	FALSE
그걸 이제 알았군	FALSE
신천지 정 말 없어져 야한다 학업 포기 시키고 가정 파괴 시키면서 그런 사람 들 다시 가정 돌려 보내기 위해 애쓰는 개종 목사 들 다시 고소하는 천하 악랄한 집단	FALSE
빨간 마티즈 조심하세요 증거 자료 분리 해 놓으시고	FALSE
살아있는 인간 하나님 믿을 때 부터 동물인지 인간 확인 해봐 야한다	FALSE
누가 신천지 종교 집단 보냐 거기 빠진 애 들 참 한 심 거지	FALSE
그 때 사람 너희 말하되 보라 그리스도 여기있다 혹 저기 있다 하여도 믿지말라 거짓 그리스도 들 거짓 선지자 들 일어나 큰 표적 기사 보이어 할수만 있으면 택 하신 자 들 미혹 하게 하리 마태복음 장 절 당신 살아계신 예수님 말씀 믿습니까 인간 이만 희의 말 믿습니까	FALSE
오송 사는 미호 중 박한 조심 들 신천지 영업 사원 임	FALSE
사이비 일반 종교 사람 마음 허약해지면 믿습니다 허나 사이비 사람 허약함을 끄 집어내어서 자길 믿으면 이 치유 된다 이런 식 회유 합니다	FALSE
인구 많아 버거운데 사이비종교 집단 싹 다 사살 했으면	FALSE
성공한 사기꾼 일 뿐 사람 마음 훔치고 세뇌 하는것도 재주 재주	FALSE
이 걸 이렇게 까야지만 알아듣는 건가 딱 보면 사이비종교 잔	FALSE
역시 무교 최고	TRUE
교세 크긴 크다 진짜 카드섹션 북한 뺨 치네	FALSE
이런 용기있는 사람 들 많이 나와 야함 맑은 정신 갉아먹는 이 단자 들	FALSE
쓰레기 집단	FALSE
알아차렸으니 다행 언능 나와라	TRUE
이만 희 애가 하나님 믿는 자체 코미디 아니냐 ㅋ	FALSE
대표 님 이왕 이렇게 커진거 제대로 터트려 진정한 종교인 되어 주세요 Jtb 뉴스룸 나가시는거 어떠세요 수많은 가족 들 피 해보고 있는거 아시잖아요 하나님 기도 합니다 진정한 용기 내어 주셔서 감사하고 쇠뿔 당김에 뺍시다 어어 어 하다 보면 신 ㅇ 지 얘 들 돈 해결 합니다 그냥 어영부영 넘어가게 됩니다	FALSE
몇 년전 편의점 설문 응 했는데 그 이후 상담 받아 보라 했다 성경 바탕 한다고 하니까 거절 했다 지 금보 신천지 유사하다는 느낌 든다 거기 가입 했다면 난 지금 정상 적 삶 살 수 없었을 것	FALSE
이만 희색 이 곧 죽 때 됐잖아	FALSE
딱 봐도 영혼 사기 종교 홀딱 빠져 삶 망치는 인간 들 제발 깨우치 기를	FALSE
하나님 팔아서 선동 하는 미친 신천지 천벌 받는다	FALSE
그냥 이만 희 연설 하는 장면 한번 봐도 저기 저렇게 매달리는 신도 이해 안감 ㅋㅋㅋ	FALSE
목적 위해 수단 방법 거짓말 눈앞 해대 자 들 어찌 종교인 말 할수있나요 기 본 양심 안 지키면서 모 무엇 위해 그러고 길 전도 하나요 제발 바로 알 사세요 얼른 나오세요	FALSE
대 깨문 달창 신천지 똑같은 거 냉정하고 객관 적 바라보면요	FALSE
거짓 영은 뿌리 뽑혀 야합니다 김남희 씨 예수님 붙잡아주셨네요 음란하고 추악한 이만 희는 신 압닙 다	FALSE
신천지 문슬람 정신 병자 들	FALSE
신천지 문제 많네요	FALSE
그냥 넷다 악질	FALSE
김남희 씨 위험하니 개인 경호원 두세요 신변 보호 요청 하셔야 할 듯 신천지 실체 진실 밝혀주시길 바 요	FALSE
빤스 목사 빠는 개독 vs 신천지 막하 막하네	FALSE
신천지 이제 잣 댓 내 ㅋㅋㅋㅋㅋㅋ	FALSE
팽 당하지 안았다면 지금 수많은 사람 들 구렁텅이 빠뜨릴 인간 회갯나는척 진심 사과 해	FALSE
저런 벌레 집단 전부 죽어야 되는데 저기 신자 들 다 관속 들어가라	FALSE
세력 싸움 밀린듯	FALSE
신천지 한국 기독교 주요 교단 이단 결의 된 곳 입니다	FALSE
신천지 달창 양쪽 다 한심한 정신 병자 들	FALSE
사이비종교 지구 상 사라져 야합니다	FALSE
또 라이 들	FALSE
저 또한 신천지 탈퇴 자 로써 영적 병든 신 천지인 들 하루빨리 세상 빛 보길 기 도합 니 김남희 씨 앞장서주시길 응원 할게요	TRUE
친구 초등학교 교사 신천지 광신도 미쳤더라 남편 엄마 다 끌어 들여서 ㅉㅉ	FALSE
김남희 너 수많은 영혼 이단 사탄 입 넣었으니 너 책임지고 그 영혼 들 빼내 야할 책임 있다 그러지 않으면 너 영원한 지옥 불속 못 나올것이다	FALSE
신천지 교주 사형 시켜서 뿌리 없애야 한다	FALSE
사람 하나님 칭하 교회 또 있습니다 하나님 교회 신천지 다를 바 없 습	FALSE
신천지 하나님 교회 똑같은 거 아니었나	FALSE
다른 곳 둘 다 사이비 종교	FALSE
좋은 기 사구만	TRUE
좌우 분간 못 사이비 빠지는 사람 들 참 많다	FALSE
성경 예수님 삥 뜯는거 봤어요 빵 몇 조각 몇 천명 볓만명 먹이는 무 유 창조 해내는게 신입 니 기본 적 정성 뭐 하면서 헌금 요구 돈 주 종교 들 가짜 입니다 자기 신 왜 굳이 돈 요 구합 일 반 교회 요새 헌금 따로 넣게 되있습니다 헌금 많이 안 한다고 눈치 주고 무시 하는 종교 가짜 입니다	FALSE
인자 폭로 해도 돌아이 신자 들 믿지 않을꺼다 왜 이미 세뇌 당했니깐	FALSE
신천지 대 깨문이나 거기 거기	FALSE
권력 중독 질병 화로 신천지 와해 시켜야 한다 종교 권력 권력 인지 그 중독 악 영향 예수 성 전 정화 아주 잘 드러난다	FALSE
그렇게 없어져야 할 종교 라면 그 걸 사람 홀리 뺏은 재산 차지 하려고 하는 겨 ㅋㅋ 똥 들 똥 튀기며 더러운 싸움 들 있네 ㅋㅋ	FALSE
한국 사이비 사기 종교 집단 천국 사 기 공화국 민낯	FALSE
신천지 나 주체사상	FALSE
치료 불가능한 정신병 집단 맞습니다	FALSE
아니 지랄 사람 하나님 믿는 자체 또 라이 아니냐 진짜 노답 요즘 신천지 길거리 대놓고 홍보 하던데 난 전단지 받자마자 보는대서 찢어 버림 ㅋㅋㅋ 걔네 들 찍 소리 못 함 정신 병자 들 신천지 벌레 들	FALSE
조사 들 해 보시 신 천지인 들 언제 신 그리 맹목 적 믿던 사람 들	FALSE
신천지 만큼 위험한것은 바로 사회주의 사회주의 정권 빠져 교회 교인 들 선동 하는 일부 목회자 들 일부 교인 들	FALSE
인간 하나님 믿었다는것이 제 정신 이제 서 돈 때문 신천지 이단 뭐 떠들고 있냐 너 이만 희나 종교 사기꾼 임 모두 알고있다 하나님 저주 받을 인간	FALSE
내 주변 신천지 교회 뭐라는 인간 있는데아주 더러운 넘 우기 험담 거 짖말하고 누명 씨 우 고 신천지 평 안 봐도 그 넘만 봐도 그 집단 알것 같다	FALSE
정신 적 에러 신천지 만듬	FALSE
일 찌 아셨네 ㅋㅋㅋ 남 들 다 아는데 지만 몰랐네	FALSE
ㅋ 윈 알고있었 눈뎅	FALSE
사이비종교 북한 김씨 숭배 그리고 잡다한 여러가지 들 그걸 믿는 인간 잘못 기본 적 지력 딸리니 헛소리 박수 눈물 흘리지 안타까운 일이 스스로 해결	FALSE
곧 청부 살인 들어가겠지	FALSE
제발 이단 신천지 빠져나오세요	FALSE
죽이겠다 덤빌지 모르니 몸조심 하 오	FALSE
요즘 젊은 애 들 취업 시켜 주보 장학금 준다니 뭣 모르고 포섭 되는데 풍비박산 시간 문제 ㅋㅋㅋ	FALSE
멍청이 들 인자 하는 ㄴ 도 나오는 마당 니 같 응 찌 끄러 기 들 그냥 돈 대는거여 제발 버릴 수도 있지만 이렇게 나오라 하는건 거기 가족 있기 때문 제발 좀 알아라 멍청이 들 ㅜㅜ	FALSE
요즘 신천지 왤케 활개 치냐 사람 들 개독 욕 한다고 너 위상 올라가는건 아니야 ㅋㅋ	FALSE
만 희 아저씨 아직 살아있음 오늘 내일 하는거 아님 이 아저씨 사기 구라 를 많이 쳐서 죽어도 곱 못 죽을듯	FALSE
디지면 지옥 행 급행열차 확정 추종자 들 똑같이 지옥 행 이 긴자 최종 구원 자 명 조만간 이만 희 디지면 다 무너질거다	FALSE
딱 봐도 사긴줄 알 있었다	FALSE
ㅋㅋㅋㅋㅋㅋ 할매 돈 떨어졌구나 그래 신천지 바보 들 좀 알아라 ㅜㅜ	FALSE
믿음 잘 못 된 예	FALSE
믿는 사람 들 이해 불가 본인 믿으세요	FALSE
용기있는 고발 체험담 통해 더 이상 신천지 이만 희에게 속지 않도록 응원 합니다	TRUE
신천지 정신 병자 들 집단 입니다	FALSE
아니 뭐 그 쪽 굳이 폭로 하지 않아도 신천지 한국 사라져야 될 종교 사기 집단 정상 적 대한민국 사람 라면 모두 알껄 비정상 적 정신 병자 들 모르지 않을까	FALSE
우린 알 있었는데 너 교인 들 몰랐지	FALSE
피해자 가해자 편 들고 있는 현상 사이비 나타나는 현상 입니다 제 있던 교회 목사 성범죄 폭로 하니 피해자 들 오히려 저 명예훼손 고소하더군요 ㅠ 사이비 집단 실체 밝히는게 쉽지 않은 이유 입니다	FALSE
근데 저 김남희 피해자 아닌 가해자 입니다 가해자 들 이만 희와 김남희 가 서로 후계 구도 놓고 싸우다 김남희 쫓겨났고 그 뒤 김남희 사이비 신천지 실체 폭로 겁니다	FALSE
나라 수사 들어가야 한다 가정 파괴 종교 다 왜 이런 걸 그냥 놔두는지	FALSE
너 몰랐지 우린 다 알 있었어	FALSE
우리나라 명이넘어요 사이비 빠진 사람 내 친구 와이프 구 할려고 들어갔다가 본인 빠져 가족 전체 사이비 jms 신천지 통일교	FALSE
에 저런 미개한 사이비 집단 속 넘어가는것 들이 잇다는게 신기하다	FALSE
사기꾼 들 신천지 믿는게 더 신기하다 쯧쯧	FALSE
초록색 넥타이 좀비 들	FALSE
지금 알아서 다 항 입니다	FALSE
이만 희 사기꾼 것 이제야 알았구나 다른 사람 들 정신 차려	FALSE
종교 자체 사기 뭐 세기 종교 과학	FALSE
그 어떤 바이러스 무서운 영혼 오염시키는 바이러스 사이비 종교 백신 없다	FALSE
그걸 이제 아셨어여 돈 앞 서니까 정신 들었나	FALSE
개독교 만 않은거 같은데	FALSE
김남희 사기꾼 던데 신천지교 몇십 억 사기 탈 로나 나갔데	FALSE
나라 좀 하지 ㅡㅡ ㅋ 청소 필요	FALSE
요지경 이 종교 믿지 과학 따르라	FALSE
가끔 인천 산곡동 가는데 그 곳 신천지 성전 이 잇어요 젊은 여자 젊은 청년 들 나오는데 사람 들 이상 해보여요 정상 적 종교 들 많은데 이단 를 모를까 요 많이 안타까워요 예수님 통해 천국 영생 이어져야하는데 교주 하나님 교주 통해 영생 이간 다는건 애시 당초 아닌것을요	FALSE
사람 신 될수 없습니다	FALSE
그 나물 그 밥 신 섬기는 사람 들 리더 들 항상 자기 살아있는 신 착각 빠짐니다 예수 그러하듯 마호메트 그러하듯 부처 그러하듯 죽은 후 후대 추앙 받는거지 살아있을 땐 철저한 구도 자 삶 살아야 합니다 신 이원 하는것은 신 위해 기도 하는 삶 사는것이고 리더 들 신 이원 하 는바 신도 들 올 곧 전하 전달자 역활 하면 됩니다 신은 각자 위치 신앙 생활 하길 원합니다 또한 신은 본분 망각 리더 들 구 원 그 자체 없애십니다 신 믿으십니까 본분 망각 하지 마세요	FALSE
울산 무거동 신천지 있던데 그것 맞나 아시 분	FALSE
더러운 귀신 사람 나갔을 때 물 없는 곳 다니며 쉬 기를 구 하 되 얻지 못 이 가로되 내 나온 내 집 돌아가리라 하고 와 보니 그 집 비고 소제 되고 수리 되었거늘 이 가서 저 더 악한 귀신 일곱 데리 들어가서 거 하니 그 사람 나중 형편 전보 더욱 심하게 되느니라 이 악한 세대 또한 이렇게 되리라 하신 예수님 말씀 마태복음 장 절 말씀 김남희 씨 응 하였다	FALSE
몸조심 하셔 야할듯 ‥ 후 폭풍 겁나	FALSE
이슬람교 종말론 크리 슬람 여호와 증인 미국 식 이슬람 모르몬교 후기 성도 스타일 크리 슬람 분위기 신천지 종말론 토착 유교 분위기 일부 기독교 형식 결합 크리 슬람 스타일 신흥종교 봅니다 유태교 기독교 원조 유태교 창 시한 유태인 조상 이슬람교 창 시한 아랍인 조상 모두 아브라함 입니다 유태교 이슬람교 기독교 모두 조상 같아요 아브라함 종교 분류 하기도 합니다 예수 이슬람 기독교 양쪽 모두 존재 합니다 이 정도 기독교 성경 창세기 아브라함 아들 들 족보 읽어도 알 수 있는 상식 수준 이	FALSE
신천지 좌표 찍고 달려오는 소리 들리나요	FALSE
인간 결핍 이용 해 돈 벌어 먹는 집단 들 참 많다 나도 어린시절 힘든 시간 보내서 기댈 곳 필요했고 마침 한 종교 만나 힘든 시기 잘 넘기긴 했지만 가정 파탄 내고 젊은이 들 꿈 인생 모두 빼앗는걸 보고 탈퇴 했다나와 보면 더 잘 보인다 무리 끼어있으면 인간관계 때문 생각 무 뎌 진 다	FALSE
신천지 이만 희 요즘 뭐함	FALSE
성도 들 등꼴 빨 먹고 세뇌 시킬라고 대가리 굴리 중 일듯	FALSE
드디어 분열 되는구나	FALSE
헛되 헛되 헛되 헛되 모든 것 헛되도	FALSE
세상 모든 일 들 측근 등 돌림 폭로 일려 지고 개혁 되지 이제 바로잡힐 때 되었지 신천지	FALSE
남 들 사 기 친돈 자기 들 끼리 재산 분쟁 있네 ㅋㅋ 어이 개 털림	FALSE
종교 정신 병자 들 종교 사회 악	FALSE
없어져라 신천지	FALSE
길거리 전단지 그만 좀 뿌려 신천지	FALSE
봉건시대 학교 게 없을 때 종교 필요했지 요즘 봉사 단체 있으면 되지 않나 이성 지성은 학교 배우는데	FALSE
터질게 터지기 시작 하는 겁니다	FALSE
저걸 믿는것 들이 참 지 들은 깨어있다 믿으니 문슬람 다른 뮈	FALSE
저런 종교 있었구나 합니다 서로 이익 위해 화이팅 하십시요 내부고발 그 여성 분 가호 깃 드시길	TRUE
담아 갑니다 안타까운 영혼 들 되돌릴 수 있는 양심선언 되길	FALSE
이만 희 전광훈 종교 가장	FALSE
흥미진진 하겠군 어서 까발려라 재미있겠다	FALSE
똥 된장 꼭 찍어 먹어야 아	FALSE
개천 이제 아작 나겠구만 화이팅	TRUE
신천지 뭐 매스게임 하냐 한국	FALSE
그래서 폭로 이유 수백억 소송	FALSE
살 있을 수 있을까	FALSE
신천지 문제 JMS 도 문제 임 JMS 신분 숨긴 체 지방 방송국 방송 나오는 인간 들 있음 이 문제 방송 포교 하는건 아닌데 지 들 행사 그런거 있을 때 어디 방송국 일 다 고 홍보 질함 알 모르게 포교 이용 당하는거 임	FALSE
사기 아닌 종교 있긴 한가 정도 차이 있을 뿐	FALSE
문선명 이만 희 정명석 다 들 전도관 출신 잖음 다 들 본인 구원 자 하는데 이단 없어져 야함 사회 악임	FALSE
사이비 중 사이비 이 기회 다 들 정신차리고 나오세요 ㅎ	FALSE
아직도 이런 사이비 믿고 사는 덜 떨어진 인간 있다는게 놀랍다 자기 자신 안 믿고 남 의지 할려고 하는 정신 상태 걸렀다 인간 살아라 골 빠진 허수아비 살지말고	FALSE
신천지 이 단 사이비종교 아웃 ㅡ 반드시 읍 어 져 야할 종교 사기 집단 중 언 의말 뭐라고 신천지 지랄 할지 쪼끔 궁금 내지 신천지 갸들 링크 보냇능데 ㅡ 암 쪼록 정신차리고 신천지 나오시오	FALSE
먼저 사과 하고 실체 폭로 해야지	FALSE
신천지 아니라 별천지 그러니까 안드로메다	FALSE
신천지 신자 들 짐승 들 어케되건 상관없다	FALSE
똑 같은 것 들 ㅋㅋ 웃겨	FALSE
문 재앙 저런거나 깔끔하게 처리 해봐라 즉 신천지 해체 하란 말 세월호 시체 팔이 그만하고	FALSE
신천지 창시자 그 딸 최 순 실 그 최 순 실의 꼭뚜 각시 박근혜 신천지 같은 뜻 새누리 그 새누리당 새 이름 자유 한국 당	FALSE
탈북자 태 영호 대한민국 국회의원 출마 한 대요 종편 출연 해 북한 얘기 밥 벌이 하는것도 꼴 뵈기 싫더니 평생 북괴 김씨 부자 찬양 하며 외교관 호의호식 하다가 마치 독립 투사 인양 보수 세력 등 업고 북괴 비판 민주 정부 욕질 감히 뺏지까지 달려고 한국 당 영 입 됐다는 평생 보수 세력 비판 입 풀칠 하던 진중권 총 부리 돌려 진보 세력 비판 하니 보수 세력 들 쌍수 들 박수 쳐 대는 아이러니 보수 죽었다	FALSE
박사모 사이비종교 제일 무섭지 않나	FALSE
신천지 통일교 기독교 불교 다 사기 ㅋㅋ 애초 종교 자체 허상 임 다 지 들 멘탈 도움 되니까 교회 절 다니는거지 물론 신 진짜 있다고 믿는 멍 ㅊ 한 놈 들 대화 가안 통 하 정신 병자 들	FALSE
🔻 왜 신천지 인자 김남희 이제 서야 이만 희 신천지 이 땅 없어져야 할 종교사 기 집단 폭로 걸까 요 지난날 저지른 죄 대한 반성 없이 재산권 법정 투쟁 유리한 입지 얻기 위 임시 술책 아닌가요 그나저나 CBS 는 신천지 OUT 은 외치면서 왜 동성애 OUT 은 외치 않고 도리어 동성애 차별금지법 옹호 지지 하는 건가 왜	FALSE
그럼 인간 차별 하자 거	FALSE
신천지 순우리말 새누리 최태민 영생교 무슨 관계 일까	FALSE
그러게 ㅜㅜ 좌파 세력 중도 당함	FALSE
맞긴 맞는 말이잖아요	FALSE
김남희 씨 신 천 지안 당 짓는 등 본인 세력 만들어 확장 신천지 방송국 무력 점령 과 몇십 억 금액 편 취하 등 본인 돈 아닌데 신천지 손해 입혔으며 이로 하여금 징역 집행유예 을 선고 받았으며 현재 재판 진행중 것 있는데 사기치는 사람 말 믿는 것 자체 거짓 이 속 는것 입니다 그리고 인간 신 될 수 없습니다 하나님 예수님 아니며 하나님 함께 하시는 목자 이십 니 이 걸 갖고 자칭 예수 오해 이해 못 하니 성경 왜곡 저리 이 말 저 말 맞지 않는 말 하는게 문 제이지 사람 보고신 앙하지 마세요	FALSE
신천지 통일교 하나님의교회 이 셋 이 땅 사라져야 됩니다	FALSE
전빤스 괴독교 보다 낫다	FALSE
종교 믿는 것 아니라 믿음 살아있는 인격 예수 그리스도 믿는 것 오직 그 분만 모든 것 되시게 하는 것 입니다 예수 그리스도 만 왕 왕 이 시 만주 주 이십 니 이러한 믿음 실재 안다면 이만 희 씨 높일 수 없습니다 주님 오실 때 가까워질수록 메시아 자처 하는 자 들 많아질 것 입니다 믿음 가족 여러분 깨어 있기를 바랍니다	FALSE
부류 대 깨문하고 똑같네 ㅋㅋㅋ	FALSE
박근혜 ᆢ 반기문 신천지 라면	FALSE
신천지 신 도의 정신 상태 대 깨문의 정신 상태 유사하다 느낌 문 천지 불린다 함	FALSE
신천지 대 깨문 달창단	FALSE
사이비 종교 빠진 인간 들 주로 택 극기 들 광화문 나가서 떠들어 싸지	FALSE
우리나라 보수 정신 병자 들 비슷하네 ㅋㅋ	FALSE
종교 란 왜 있어야 하는지 생각 불교 천주교 빼고는 다 없어져야 함	FALSE
저건 양심선언 볼 수 없다 본인 가해 집단 중심 있었음에도 신도 들 피해자 들 사과 한마디 없이 씨 건방지게 뭐 예수님 은혜 SCJ 와 다른 뭐 또 다른 선 악 프레임 짜기 후 창업 위 과정 게 뻔하다 김 원장 측근 애 들 여기저기 반대편 반증 사 역 하는 곳 컨택 한 거 공공 연하 알려진 사실 존 존이도 아이덴티티 저렇게 잡으면 같이 말려 들어가는 것 안된다 답 없다	FALSE
인간 인간 하나님 정말 안타깝다 하늘 아버지 이 모습 보면 어떤 생각 하실까 가증 것 들 하나님 자리 앉아 왕 노릇 있구나	FALSE
국가 적 신천지 엄금 공수부대 보내서 우두머리 싸 그리 사형 시키고 강제해산 시켜 야한다 또한 신천지 빠진 사람 들 급 정신병 자 간주 약물 치료 감금 치료 동반 시켜야 한다 종교 빠진 사람 정신 병자 들	FALSE
미친 집단 노답	FALSE
이만 희 신천지 vs 전광훈 한기총 둘 중 누가 제일 나을까요	FALSE
둘다 그냥 접시 코밖 죽는 게 나음	FALSE
하나님 사랑 이자 하나님 소중하고 사랑스러운 자녀 우리 모두 알아야 할 사실 우리 언제 죽을지 오늘 당장 죽을지 내일 죽을지 모릅니다 예수님 탄생 하신 이전 이후 B C 와 A D 를 통 해서도 그 누구 하지 못 부활 통 해서도 유튜브 불교 이슬람교 간증 없지만 하나님 천국 지옥 간증 많다는 것 통 해서도 예수님 믿는 신앙 종교 아닌 유일한 진리 임 알 수 있습니다	FALSE
추천 유튜브 채널 하나님 음성 사모 하는 사람 들 Emmanuel TV 한국어 티비 조슈아 치유 사 역자 님 추천 네이버 블로그 이 세대 가기 전 추천 책 하나님 대사 결혼 배우다 육아 배우다 하나님 각자 맞게 창조 하신 피조 물 여러분 사람 들 대우받기 위함 아닌 하나님 찬양 하기 위해 지음 받으신 이사야 여러분 읽어주셔서 감사해요 종교 덫 빠지는 대신 우리 모두 천국 소망 안 하나님 동행 하며 거듭 삶 살다가 천국 만나요	FALSE
어떻게 신 천지인 들 이렇게 댓글 내 용이 다 똑같은가요	FALSE
문 천 지도 폭로 해주세요	FALSE
걍 종교 전체 멍청한 것 들임	FALSE
통일교 사이 비아 겠어 ❓ 세계 일보 통일교 꺼 ❓ 고로 세계 일보 사이비 신문 😅😅😅😅😅😅😅😅😅😅😅😅😅😅😅😅😅😅😅😅😅😅😅😅😅 통일교 사이 비아 겠어 ❓ 세계 일보 통일교 꺼 ❓ 고로 세계 일보 사이비 신문 😅😅😅😅😅😅😅😅😅😅😅😅😅😅😅😅😅😅😅😅😅😅😅😅😅 통일교 사이 비아 겠어 ❓ 세계 일보 통일교 꺼 ❓ 고로 세계 일보 사이비 신문 😅😅😅😅😅😅😅😅😅😅😅😅😅😅😅😅😅😅😅😅😅😅😅😅😅	FALSE
신천지 댓글 부대 좋아요 부대 있던데 세계 일보 는 신천지 찬양 하는 기사 그만 좀 올려라	FALSE
빤 쓰 전광훈 낫다	FALSE
인간 예수 인간 몸 입은 신 믿는 너희 이만 희를 신 믿는 저 놈 들 뭐 다르며 더 완전한 존재 믿고 추구 하기 위해 신 무형 존재 만들어 거기 다가 질투 화 내고 벌도주고 때론 사랑 도하 상도 주는 인간 성향 부여 해서 그걸 믿는다고 하는 너희 도대체 뭐 다르고 뮈 더 나은거냐	FALSE
기독교도 없어져 야할 종교 단체 아닌가	FALSE
지금 세상 신천지 다른 기독교 이단 타락한건 똑같지 않나	FALSE
예수 쟁이 신천지 똑같이 단체 정신병 ㅋㅋㅋ	FALSE
신천지 뿐 아니라 가짜 뉴스 배포 하는 CBS 도 각성 하	FALSE
ㅋㅋ 전광훈 영 입 추천 드립니다 ㅋㅋ 신천지 다시 살려면 그 방법 ㅋ	FALSE
너 네 하나같이 할줄아는게 욕 없냐 왜 그렇게 똑같이 무식하냐	FALSE
그동안 가정 무너 뜨 리 청년 들 삶 갉아먹었으니 회계 하는 마음 다시 돌려놓 기를 바 요 지금 돌아오셨으니 감사합니다 응원 합니다	TRUE
신천지 옹호 하는건 아닙니다만 거기 붙어서 잘 먹고 잘살다가 잇속 틀려 나와서 소송 벌이 여론 흠집 내면 사이비 없어져 야할 집단 그러는 모양새 보기 좋지는 않네요 거기 잘나갈 때 내부고발자 같이 나왔다면 양심선언 봐주겠지만 이건 뭐 소송 벌이는 그 수백 원 돈 누구 주머니 나온 걸까 요 그거 나눠 먹자고 소송 중 사람 좋게 보이질 않는군요	FALSE
저런 단체 홀리 인간 들 더 이해 안 간다 ㅋ 걍 착하게 살믄되 ㅋㅋ	FALSE
하나님 살아계십니다	TRUE
작년 신천지 교인 차량 점포 입구 막은 채 주차 되어있어서 차량 이동 해달라고 했으나 이 땅 니 땅 며 오히려 저 겁 박주더군요 가량 지나 예배 끝나고 차량 끌고가더군요	FALSE
종교 인간 들 만든 해악 한 것 부처 예수 언제 그런것 만들라 했나 소위 성직자 건 기생충 같은것이고 종교인 이 기적 편집증 환자 임 악마 천사 바로 인간 임 성경 불경 등 경전 후대 픽션 도배 된 인간 들 만든 이야기	FALSE
사이비 종교 ᆢᆢ 해체 답 여러 사람 인생 잡는다 ᆢ 종교 사기꾼 들 ᆢ 돈 없으면 모두 거지 ᆢ	FALSE
책 받아 쳐 먹은 이 긴자 이만 희 씨 요 그래서 저렇게 들 이만 희를 따르고 있죠 신천지 OUT	FALSE
신천지 종교사 기 집단 하나님 깨닫게 해주셔서 감사합니다 성령 충만 케 해 주 옵 소서	FALSE
신천지 상대로 재산권 민사소송 누가 만들어 준 재산 누구 것 이만 희가 땀 흘려 번 돈 사기 부정 축재 돈 대한 민사소송	FALSE
저런데 빠지는 바보 들 더 웃긴거다	FALSE
팩트 신천지 빼고 다 아는 사실	FALSE
ㅈㄹ 한다 권력 맛좀 보다가 이 젠 돈 때문 폭로 한다 깝 치네 똥 된장 찍어 먹어 봐야 아냐 신은 무슨 딱 봐도 이만 희가 찐 따 같지 않던	FALSE
새누리 끝났구나	FALSE
문 술람 동 급임	FALSE
요물 사이비 교주 마니는 청년 들 영혼 털이범 법 심판 기다리고있다 탈탈 털려야지 달닽 떨고있겠다 꼴 좋다	FALSE
언젠가 대 깨문에서도 이런 인물 나오길 간절하게 기도 해 본다	FALSE
야 이 ㅆㄹ 기 ㄴ 아 너 똑같은 쓰레기 면서 ㅋㅋㅋ 신천지 반 니 꺼 생각 했는데 한 푼 못 받고 쫒 겨나고 ㅋㅋㅋ 그 많은 청년 들 사이비 종교 빠뜨리냐	FALSE
사이비 이단 종교 병천 역병 온 조선팔도 똥 칠하구 증말 나쁜 사비 집단 고만 사기 회개 얼마 남지 않은 인생 똑바로 살아라	FALSE
인간 쓰레기 들 이런 죄 짓고도 편할줄 알았어 벌 받기를	FALSE
하 영상 보는 동안 아니겠지 아니겠지하면서도 증거 되는 음성 사진 들 일팔 정말 그동안 시간 낭비했던걸 생각 하면 너무 억울하네요 그때 순간 순간 들 정말 소름 돋게 딱 딱 맞아 떨어지는게	FALSE
또 시작 ㅡㅡ 한심한	FALSE
진짜 둘 영적 결혼 햇 헐	FALSE
사기꾼 들 다 싫다	FALSE
종교 사기 들 사라져라	FALSE
이제 알았다니 다행 그동안 많은 영혼 들 이단 빠지게 한 죄 회개 하시고 진리 돌아오길	FALSE
결국 은 돈 문제 걸려 있네	FALSE
https://youtu.be/9_rLQvs9K1g 이단 사이비 신천지 우상숭배 적그리스도 종교 사 기수법 공개 유튜브 채널 이단 상담 정진영 목사	FALSE
결국 신앙 아니라 돈 보고 붙어있었던거네요 ㅡㅠ 금전 적 이익 위해 세계 돌아다니며 거짓말 했던 김남희 이 사람 신앙 돈 쫓은거네요 ㅎㅎㅎㅎㅎ 부끄럽지도 않은 가봅니다 ㅡ 돈앞 비슷하지만 돈 때문 몸 바쳐 신앙 하는 척 했던것이고 ㅍㅎㅎㅎㅎㅎ 돈 더 받아내려 수작 부리는것이고 ㅎㅎ	FALSE
같이 나쁘다 ㆍ 이단 항상 돈 여자 따르고 있다 ㆍ	FALSE
신천지 어차피 망할건데 나 호들갑 그만 떨어야지 하는데 댓글 왜 이렇게 많은지	FALSE
신천지 이름 맘 안든다	FALSE
신천지 ㅋㅋㅋ	FALSE
광주 신천지 웰케 많냐 유스퀘어 터미널 지하 단속 안 하냐 공무원 돈 받았냐 저녁 존나 많아	FALSE
재밋다 ㅋㅋ	FALSE
이단 들 하나같이 좌파 사탄 졸개 어둠 좌피 것 결과	FALSE
이단 들 하나같이 좌파 사탄 졸개 좌 피임 입증	FALSE
해방촌 출신 목사 다 살인마 퀴 죽창 사람 찔러 죽 강 간 하던 목사 들	FALSE
신천지 성도 여러분 들 디모데전서 장 절 보세요 뭐라고 적혀 있습니까 하나님 사람 사이 중 보자는 한 분 그리스도 예수 만 되어있지 다른 한 분 더 있는데 보혜사 대 언 의사 자 곧 존존 티비 김남희 탈탈 털리겠느니라 되어있지 않습니다 성경 이 긴자 찾기 위 약도 모 지 파장 님 그러셨죠 근데 어쩌나 요 목적지 잘못 찾아 가셨습니다 물론 여러분 잘못 없어요 여러분 그저 네 비만 믿고 간거니까 요 여러분 인도 그 엉터리 네비게이션 인섬교 강사 죽이는게 마땅하겠지요 곧 그리 될 겁니다	FALSE
이쯤 되면 지 파장 들 양심선언 할 때 되었는데 양심선언 미리 하지 혹시 법접 들어가면 정상 참작 되는데 박 그네 하수 처럼 되지 너거 지 파당 들 다 알 있잖아 ㅎ 거짓 나가면 할거 없으니 거기 나아 있는거 다 아는데 하나님 회개 진정한 신앙 되는게 어떠세요	FALSE
남 일이 아니야 정말 위험	FALSE
사이비 신천지 붙잡혀 있다면 이제 빨리 나오세요	FALSE
저런거에 빠져 돈 잃고 몸 잃고 한심한 작자 들	FALSE
ㅋㅋㅋ 구원 자 ㅋㅋ 난 지금 봐도 알겠다	FALSE
세뇌 되서 진짜 믿는 사람 있어요 지금 문 재앙 따르는 대 깨문 같이	FALSE
신천지 이단 대표 주자 지구 밖 영원히 추방	FALSE
하나님 까불면 죽어 이후 아주 노골 적 설치던데 드디어 돈 갖고 싸우나	FALSE
하나님 왜 유언 남겨 교회 사리 사욕 채우기 위해 돈 바치 했을까 하나님 없는 사람 왜 등처 먹는 겨	FALSE
뭐 과 하면 탈 이나 법	FALSE
SCJ 신도 들 거기 같이 패 악질 하다가 나와서 양심선언 저딴 사과 도 없는 피해자 코스프레 하는 것 들 도 긴 개긴 저 양심선언 웃기지도 않네 저러면 SCJ 시즌 안되는 거	FALSE
그 곳 한기총 소속 강제 개종 하 곳 입니다이 종교 문제 아닙니다	FALSE
지 정신 아닌것 들이 모여있는 곳	FALSE
지금 서로 죽여라 시작	FALSE
신천지 또 있자나 교인 들 외국인 결혼 시키고 우리나라 부 축구팀 가지고있고 ㅋ	FALSE
신천지 뭐	FALSE
신천지 사이비종교 집단 입니다거긴 이 만휘 인간 들 율법 어겨서 유월절 찾아왔다는 아주 신 박 개 소리 자연 합니다 이 만휘 하나님 모시는데 인간 입니다 저 인간 병들어 죽으면 뭐라 할지 진짜 궁금하네요	FALSE
마니야 신천지 함께 가자구나 내 거기 박살 내 주마	FALSE
용기 있는 선택 축하 드립니다 속히 그 실체 폭로 거짓 임 밝혀내는것이 그동안 수많은 사람 미혹 한 죄 갚을수 있는 유일한 길 입니다	FALSE
신천지 같은데 속 넘어가는 사람 똑같은 사람 아닌가	FALSE
님 사기 당한 사람과 한 사람과 같다라는 논리 같은 말 하고 있습니다	FALSE
듣보잡 종교 ㅋㅋㅋ 신 천리 아는데 ㅋㅋ	FALSE
신천지 듣보잡 전세계 나가면 듣보잡 이긴 하겠네요 성도 수가 십만 단위 였나 그러니까	FALSE
몸조심 해야 할거 같은데	FALSE
늦게나마 자백 했네 제발 거짓 사이비 집단 다 들 빠져나오길 기 도합 니	FALSE
응원 합니다	TRUE
신천지 이런 글 내리는거 칼 이 던데 어찌 안 내려 가네요 ㅎㅎㅎ	FALSE
어 폭로 되고 할 것 없이 신천지 신도 다 아는 사실 같은데	FALSE
슬슬 정체 탄로 나기 시작	FALSE
신천지 해체 때 된것이다	FALSE
불쌍한 영혼 들 소 경과 다름 없는 영혼 들 ㅡ 잠자는 영혼 들 깰지어다 ㅡ 깰지어다 지옥불 떨어진다 속이 그 속 나올지어다	FALSE
그 안 있으면 세뇌 돼서 모르지 맞고 사는 여자 들 그렇잖아 팔자 ㅋ 누구 어디 다 똑같다	FALSE
오 요셉 기자	FALSE
지금 천하 그 악랄하게 지었던 죄 자복 하나님 긍휼 하 심 구해 이 무식 무지 어리석은 하루살이 같은 죄 많은 영혼 들 단 한 번 예 수 그리스도 통해 하나님 은혜 실제 체험 해보지도 못 어리석은 영혼 들 하나님 진짜 존재 하시는 분이시다	FALSE
지금 서 김남희 무슨 말 할지라도 자신 이 만 희에게 속 았 다 등 김남희 이 만 희와 똑같은 종교 빙자 사기꾼 죄인 태어난 인간 절대로 구원 자 하나님 될 수도 없으며 되지도 않는다 김남희 처음 이를 알 있으면서 이 만 희를 통해 호가호위 하다가 결국 과욕 토사 구 팽 당한 것 그런데 지금 와서 헛소리 하고있네 너희 들 악랄한 종교 사기 이 땅 얼마나 많은 사람 들 가정 들 이개 박살 났는지 진짜 하나님 살 계심 하나님 공 의 심판 전혀 모르는 너희 들 지옥 불심 판이 기다리고 있다	FALSE
잘 탈퇴 하셨습니다 할렐루야 진정한 구원 자 되신 예수님 섬기시길 바랍니다	FALSE
쥬 라차 ㅂㅅㄷ 신천지 다 죽어라 사이비 ㅅㅋㄷ	FALSE
구원 자 믿는게 비정상 이미 다 알 폭로 들어 보고싶네	FALSE
이미 다 아는데 새삼	FALSE
사이비 다 그런지 뭐 ㅋㅋㅋ	FALSE
나미 님 ㅅㅊㅈ 얘 들 어떤 짓 할줄 모르니 신변 조심하세요 용기내어 주셔서 감사하구요 재산 법적 분할 하시면 하나님 이름 기부 많이 부탁드립니다	FALSE
신천지 전광훈 ᆢ 하느님 팔이 ᆢ	FALSE
신천지 신도 대 깨문이나 그 년놈 들 그 년놈 들	FALSE
그 때 사람 너희 말하되 보라 그리스도 여기있다 혹 저기 있다 하여도 믿지말라 거짓 그리스도 들 거짓 선지자 들 일어나 큰 표적 기사 보이어 할수만 있으면 택 하신 자 들 미혹 하게 하리 마태복음 장 절 당신 살아계신 예수님 말씀 믿습니까 인간 이만 희의 말 믿습니까	FALSE
종교 사 기 집단 이 종교 사칭 하여 수많은 자 들 돈 긁어 모았다	FALSE
신천지 통일교	FALSE
사람 하나님 믿는 자가 불쌍해 신천지 가정 자녀 망치는 단체	FALSE
하나님 사랑 이자 하나님 소중하고 사랑스러운 자녀 우리 모두 알아야 할 사실 우리 언제 죽을지 오늘 당장 죽을지 내일 죽을지 모릅니다 예수님 탄생 하신 시점 이전 이후 BC 와 AD 를 통 해서도 그 누구 하지 못 부활 통 해서도 유튜브 불교 이슬람교 간증 없지만 하나님 천국 지옥 간증 많다는 것 통 해서도 예수님 믿는 신앙 종교 아닌 유일한 진리 임 알 수 있습니다	FALSE
추천 유튜브 채널 하나님 음성 사모 하는 사람 들 Emmanuel TV 한국어 티비 조슈아 치유 사 역자 님 추천 네이버 블로그 이 세대 가기 전 추천 책 하나님 대사 결혼 배우다 육아 배우다 하나님 각자 맞게 창조 하신 피조 물 여러분 사람 들 대우받기 위함 아닌 하나님 찬양 하기 위해 지음 받으신 이사야 여러분 읽어주셔서 감사해요 종교 덫 빠지는 대신 우리 모두 천국 소망 안 하나님 동행 하며 거듭 삶 살다가 천국 만나요	FALSE
빨 리도 끝났네 ㅋㅋㅋ	FALSE
나 예전 기독교 믿다가 하나님 섬긴다느니 그런 말 넘 싫어서 무교 된 사람 하다못해 신천지 같은 인간 섬기는게 말 되냐 자존감 갖고 살아라 믿을건 내 자신 뿐	FALSE
아는 사람 들 다 알고있지 그러니까 안 빠지는거고	FALSE
신천지 이만 희 죽으면 뭐라고 할지 궁금하다 하나님 교회 사례 짐작 된다만 참 딱 하다 들	FALSE
나라 망할려면 여기저기 사이비 판친다더니	FALSE
그걸 이제 알았냐 난 진즉 알았다 ㅋ 저런 인간 하나님 믿는것 자체 정신병	FALSE
당신 그 정신 병자 들 중 하나 였다는 거 당신 들 빼고 나머진 이미 알 있었습니다	FALSE
세습 모든 문제 출발 세습 인자 어디 있어 어디 일인자 세습 뿐	FALSE
신천지 인자 있다는 게 더 놀랍다 ㅋㅋㅋㅋ 무슨 깡페조직	FALSE
사람 구원 자라는데 믿어지는 사람 더 이상	FALSE
신천지 가짜	FALSE
가족 파탄 하는 종교 필요없다 있어서도 존재 해서도 안되는 종교 뿌리 뽑아야 한다 헌법 개정 해야 한다 법안 보호 받고 있으니 더 난리	FALSE
사이비 교단 세상 종말 시킬수도 있다 더불어 돌림빵 당 같은	FALSE
이쯤 되면 지 파장 들 양심선언 할 때 되었는데 양심선언 미리 하지 혹시 법접 들어가면 정상 참작 되는데 박 그네 하수 처럼 되지 너거 지 파당 들 다 알 있잖아 ㅎ 거짓 나가면 할거 없으니 거기 나아 있는거 다 아는데 하나님 회개 진정한 신앙 되는게 어떠세요	FALSE
신천지 현 정권 엄청나게 지원 해준다는데요	FALSE